acl	de es fr gl pl sv
alsaplayer	de en_GB fr pl sv
alsa-utils	de fr ja
alsa-utils	ja ru	alsaconf
aspell	be ca cs da de en_GB es fr ga it mn nl pt_BR ro ru rw sk sl sr sv tg uk vi wa
atk	af am an ar as ast az be@latin be bg bn_IN bn bs ca ca@valencia cs cy da de dz el en_CA en_GB en@shaw eo es et eu fa fi fr ga gl gu he hi hr hu hy id is it ja ka kk km kn ko ku li lt lv mai mk ml mn mr ms nb ne nl nn oc or pa pl ps pt_BR pt ro ru rw si sk sl sq sr@ije sr@latin sr sv ta te tg th tk tr tt ug uk vi wa xh yi zh_CN zh_HK zh_TW zu	atk10
attr	cs de es fr gl nl pl sv
binutils	bg da es fi fr id it ja ro ru rw sk sv tr uk vi zh_CN zh_TW
binutils	da es fi fr id ja ro ru rw sv tr uk vi zh_CN	bfd
binutils	es fi fr id ja ru rw tr	gas
binutils	bg da de eo es fi fr ga id it ja ms nl pt_BR ro ru rw sr sv tr uk vi	gprof
binutils	bg da es fi fr ga id it ja sv tr uk vi zh_CN zh_TW	ld
binutils	da de es fi fr ga id it nl pt_BR ro sv tr uk vi zh_CN	opcodes
bison	ast da de el eo es et fi fr ga gl hr hu id it ja ky lt lv ms nb nl pl pt_BR pt ro ru sl sq sr sv th tr uk vi zh_CN zh_TW	$P-runtime
bison	da de el eo es et fi fr ga hr id it ja ms nb nl pl pt_BR pt ro ru sr sv tr uk vi zh_CN zh_TW
dialog	ar be@latin bg ca cs cy da de el eo es et eu fi fr ga gl hi hr hu id is it ja ku lt lv mg mk ms nb nl pl pt_BR pt rm ro ru rw sk sl sq sr sv sw th tr uk vi wa zh_CN zh_TW
e2fsprogs	ca cs de es fr id it nl pl sv tr vi zh_CN
efreet	cs de el eo es fr it ja ko nl pt ru sl zh_CN
elementary	ar az_IR cs de eo fa fr he it ko_KR nl ps pt ur yi zh_CN
elfutils	de en@boldquot en@quot es ja pl uk
enna	da de el en@boldquot en@quot es fr it nl pl pt_BR ru tr uk zh_CN zh_TW
exiv2	de es fi fr pl ru sk
flex	ca da de es fi fr ga ko nl pl pt_BR ro ru sv tr vi zh_CN
galculator	da_DK de es es_MX fr hu ja kk_KZ lt pl pt_BR pt ro ru sk sv tr zh_CN zh_TW
gdb	da es fi fr id ja ro ru rw sv tr uk vi zh_CN	bfd
gdb	da de es fi fr ga id it nl pt_BR ro sv tr uk vi zh_CN	opcodes
gdbm	de fi ja pl uk
gdk-pixbuf	af ang ar as ast az be@latin be bg bn_IN bn br bs ca ca@valencia crh csb cs cy da de dz el en_CA en_GB en@shaw eo es et eu fa fi fr ga gl gu he hi hr hu hy ia id io is it ja ka km kn ko ku li lt lv mai mi mk ml mn mr ms my nb nds ne nl nn nso oc or pa pl ps pt_BR pt ro ru si sk sl sq sr@ije sr@latin sr sv ta te th tk tr tt ug uk uz@cyrillic uz vi wa xh yi zh_CN zh_HK zh_TW
geany	ar ast be bg ca cs de el en_GB es et eu fa fi fr gl he hi hu id it ja kk ko lb lt mn nl nn pl pt_BR pt ro ru sk sl sr sv tr uk vi zh_CN zh_TW
gegl	es fr pl ru sl	gegl-0.2
gettext	be bg ca cs da de el en@boldquot en@quot eo es et fi fr ga gl hr id it ja ko nb nl nn pl pt_BR pt ro ru sk sl sr sv tr uk vi zh_CN zh_HK zh_TW	gettext-runtime
gettext	be bg ca cs da de el en@boldquot en@quot es et eu fi fr gl id it ja ko nb nl nn pa pl pt_BR pt ro ru sk sl sr sv tr uk vi zh_CN zh_TW	gettext-tools
gmpc	ar bg bn bs cs da de el en_CA en_GB es et fi fr gl he hi hu hy id it ja jv lv ml ms nb ne nl oc pl pt_BR pt ro ru sq sv th tr zh_CN zh_TW
gnutls	cs de en@boldquot en@quot fr it ms nl pl sv vi zh_CN	lib$P
gpicview	af ar bg bn_IN bn ca cs da de el es es_VE et eu fa fi fr frp gl he hr hu id it ja ko lt ml ms nb nl nn pl ps pt_BR pt ru sk sl sr sv th tr uk ur ur_PK vi zh_CN zh_TW
gst-plugins-base-1.0	af az bg ca cs da de el en_GB eo es eu fi fr gl hr hu id it ja lt lv nb nl or pl pt_BR ro ru sk sl sq sr sv tr uk vi zh_CN
gstreamer-1.0	af az be bg ca cs da de el en_GB eo es eu fi fr gl hr hu id it ja lt nb nl pl pt_BR ro ru rw sk sl sq sr sv tr uk vi zh_CN zh_TW
gstreamer	af az be bg ca cs el en_GB eo eu fi gl hu ja lt nb nl pl ro rw sk sl sq sr sv tr uk vi zh_TW	gstreamer-0.10
gtkspell	af be cs da de el eo es eu fi fr ga gl hu hy id it ja ky lt lv mn ms nb nl pl pt_BR pt rm ro ru rw sk sl sq sr sv th tr uk vi wa zh_CN zh_HK zh_TW
kbd	cs da de el eo es fr gr id it nl pl ro ru sv tr uk vi zh_CN
leafpad	bg br ca cs da de el eo es eu fi fr ga gl he hu id it ja ko lt lv nl nn pl pt_BR pt ru sk sl sr sv ta tr uk vi zh_CN zh_TW
libexif	be bs cs da de en_CA en_GB es fr it ja nl pl pt_BR pt ru sk sq sr sv tr vi zh_CN	libexif-12
libgpg-error	cs de fr it nl pl ro sv vi zh_CN
libgsf	ca cs da de en_GB es eu fr gl it nb oc pa pl pt_BR pt sl sv zh_CN zh_HK zh_TW
libidn	cs da de en@boldquot en@quot eo fi fr id it ja nl pl ro sr vi zh_CN
libwebkit	ar bg cs de el en_CA en_GB eo es et eu fr gl gu he hu id it ko lt lv mr nb nl pa pl pt_BR pt ru sl sr@latin sr sv uk vi zh_CN	webkit-2.0
lxappearance	ar be bg cs da de el en_GB es et eu fa fi fo fr gl he hr hu id is it ja kk ko lg lt nl pa pl pt_BR pt ro ru sl sr@latin sr sv te tr tt_RU ug uk ur ur_PK vi zh_CN zh_TW
lxappearance-obconf	ar be bg bn_IN cs da de el en@boldquot en_GB en@quot es et eu fa fi fo fr gl he hr hu id it ja kk ko lg lt nb nl pl pt_BR pt ro ru sl sr@latin sr sv te tr tt_RU ug uk vi zh_CN zh_TW
lxinput	af ar ast be bg bn_IN bn ca cs da de el en_GB eo es es_VE et eu fa fi fo fr frp gl he hr hu id it ja kk ko lg lt ml ms nb nl nn pl ps pt_BR pt ro ru si sk sl sr@latin sr sv te th tr tt_RU ug uk ur ur_PK vi zh_CN zh_TW
lxpanel	af ar be bg bn_IN bn ca cs da de el en_GB es es_VE et eu fa fi fo fr frp gl he hr hu id it ja kk km ko lg lt ml ms nb nl nn pa pl ps pt_BR pt ro ru sk sl sr@latin sr sv te th tr tt_RU ug uk ur ur_PK vi zh_CN zh_TW
lxrandr	af ar ast be bg bn_IN bn ca cs da de el en_GB es es_VE et eu fa fi fo fr frp gl he hr hu id it ja ko lg lt ml ms nb nl nn pl ps pt_BR pt ro ru sk sl sr@latin sr sv te th tr tt_RU uk ur ur_PK vi zh_CN zh_TW
lxsession-edit	af ar ast be bg bn_IN bn ca cs da de el en_GB es es_VE et eu fa fi fo fr frp gl he hr hu id it ja ko lg lt ml ms nb nl nn pa pl ps pt_BR pt ro ru si sk sl sr@latin sr sv te th tr tt_RU uk ur ur_PK vi zh_CN zh_TW
lxsession	af am ar ast be bg bn_IN bn ca cs da de el en_GB es es_VE et eu fa fi fo fr frp gl he hr hu id it ja ko lg lt ml ms nb nl nn pa pl ps pt_BR pt ro ru si sk sl sr@latin sr sv te th tr tt_RU uk ur ur_PK vi zh_CN zh_TW
lxtask	af ar bg bn_IN ca cs da de el es es_VE et eu fa fi fr frp gl he hr hu id it ja ko lt ml ms nb nl nn pl ps pt_BR pt ru sk sl sr sv tr uk ur ur_PK vi zh_CN zh_TW
lynx	ca cs da de en eo et fi fr hu id it ja nl pt_BR ru sl sv tr uk vi zh_CN zh_TW
make	be da de es fi fr ga gl he hr id it ja ko lt nl pl pt_BR ru sv tr uk vi zh_CN
mc	az be bg ca cs da de_CH de el en_GB eo es et eu fa fi_FI fi fr gl hr hu ia id it ja ka kk ko lt lv mn nb nl pl pt_BR pt ro ru sk sl sr sv sv_SE szl ta tr uk vi wa zh_CN zh_TW
mercurial	da de el fr it ja pt_BR ro ru sv zh_CN zh_TW	$PY/$P/locale/%/$LC	hg
mhwaveedit	de es fr it pl ru sv zh_CN
ms-sys	sv
nano	bg ca cs da de es eu fi fr ga gl hu id it ms nb nl nn pl pt_BR ro ru rw sr sv tr uk vi zh_CN zh_TW
ncmpc	cs da de eo es fi fr gl he hu it ko nb nl pl pt_BR ru sk sv uk zh_CN
obconf	ar be cs da de el en@boldquot en@quot es et fi fr he hr hu it ja lt lv nl no pl pt_BR ro ru sr@latin sr sv tr zh_CN zh_TW
pam	ar as bn_IN ca cs da de es fi fr gu he hi hu it ja kk km kn ko ml mr ms nb nl or pa pl pt_BR pt ru si sk sr@latin sr sv ta te tr uk vi zh_CN zh_TW zu	Linux-PAM
parcellite	cs da de es fr hu it ja nb pl pl_PL pt_BR ro ru sv tr zh_CN
parted	ca cs da de es fr gl id it ja nl nn pl pt_BR pt ro ru rw sk sl sr sv tr uk vi zh_CN zh_TW
popt	cs da de eo es fi fr ga gl hu id is it ja ko lv nb nl pl pt ro ru sk sl sv th tr uk vi wa zh_CN zh_TW
qarte	de fr pt	$US/$P/locale/%/$LC
retawq	de es fr ja pt_BR
sakura	ca cs de es fr hr hu it ja ko pl pt_BR ru zh_CN
sed	af ca cs da de el eo es et eu fi fr ga gl he hr hu id it ja ko nl pl pt_BR pt ro ru sk sl sr sv tr uk vi zh_CN zh_TW
shared-mime-info	ar az be@latin bg_BG bg bn_IN ca ca@valencia cs cy da de el en_GB eo es eu fa_IR fa fi fo fr ga gl he hi hr hu ia id it ja ka kk ko lt lv ms nb nl nn pa pl pt_BR pt ro ru rw sk sl sq sr@latin sr sv te tr uk vi wa zh_CN zh_HK zh_TW
slitaz-base-files	el es fr pl pt_BR ru sv	slitaz-base
slitaz-tools-boxes	el es fa fr pl pt_BR ru sv zh_CN zh_TW	tazbox
slitaz-tools-boxes	es fa fr pl pt_BR ru sv	slitaz-boxes
slitaz-tools	el es fa fr pl pt_BR ru sv
tar	bg ca cs da de el es et eu fi fr ga gl hr hu id it ja ko ky ms nb nl pl pt_BR pt ro ru sk sl sv tr uk vi zh_CN zh_TW
tazinst	el es fr pt_BR ru sv	installer
tazinst	es_AR fr pt_BR ru
tazinst	pt_BR ru	slitaz-installer
tazirc	fr pt_BR
tazlito	el es_AR fr pl pt_BR	tazlito-wiz
tazweb	fr pt_BR ru
tinycm	fr pt_BR
util-linux	ca cs da de es et eu fi fr gl hr hu id it ja nl pl pt_BR ru sl sv tr uk vi zh_CN zh_TW
viewnior	ar bg ca ca@valencia cs da de el es fi fr gl he hu it ja lt nl oc pl pt_BR pt ru sk sr sv tr uk zh_CN
vte	am ang ar as ast az be@latin be bg bn_IN bn bs ca ca@valencia cs cy da de dz el en_CA en_GB en@shaw eo es et eu fa fi fr ga gl gu he hi hr hu id is it ja ka kn ko ku ky li lt lv mai mi mk ml mn mr ms nb nds ne nl nn oc or pa pl pt_BR pt ro ru rw si sk sl sq sr@latin sr sv ta te th tr ug uk vi wa xh zh_CN zh_HK zh_TW	vte-0.0
wbar2	de es fi	wbar
wget	be bg ca cs da de el en_GB eo es et eu fi fr ga gl he hr hu id it ja lt nb nl pl pt_BR pt ro ru sk sl sr sv tr uk vi zh_CN zh_TW
wput	da de el es fi fr it nl pl ru sv tr zh
xine-lib	cs de en_US eo es eu fr it ja pl pt_BR sk tr	libxine2
xorg-xkeyboard-config	af az bg ca crh cs da de el en_GB eo es fi fr gl hu id it ka ko ky lt nb nl pl ro ru rw sk sl sq sr sv tr uk vi zh_CN zh_TW	xkeyboard-config
xz	cs de fr it pl
yad	de fr it pt_BR ru sk uk zh_TW
