0install	de es sv	zero-install
a2ps	ca cs da de es fr it ja ko nl no pl pt ru sl sv tr
acl	de es fr gl pl sv
alarm-clock-applet	ar ast be bg ca cs da de es et fi fo fr gl he hi hu id it ja ka la ms nb nl nn pl pt_BR pt ru si sv tr uk zh_CN zh_TW
alarm-clock	ar bg bs ca cs da de el en_CA en_GB es eu fa fi fr he hu id it ja ko la lv mk nb nds nl nn pl pt_BR pt ro ru si sk sl sr sv tr zh_CN zh_TW
alsaplayer	de en_GB fr pl sv
alsa-utils	de fr ja
alsa-utils	ja ru	alsaconf
amule	ar ast bg ca cs da de el en_GB es et_EE eu fi fr gl he hr hu it_CH it ja ko_KR lt nl nn pl pt_BR pt_PT ru sl sq sv tr uk zh_CN zh_TW
appdata-tools	en_GB
aqualung	de hu it ru sv uk
ardour	cs de el es eu fr it nn pl pt pt_PT ru sv	gtk2_ardour
ardour	el es eu fr it nn pl ru sv	libardour2
ardour	el es eu nn pl pt ru	libgtkmm2ext
aria2	ar bg bn ca da de el en@boldquot en@quot es fa fi fil fr he hr hu id it ja kk ko ms nb nl nn oc pl pt_BR pt ro ru sk sr sv th tr uk vi zh_CN zh_HK zh_TW
ario	ar ca cs da de en_AU en_CA en_GB eo es et fi fr ga he hr hu id it ja nb nds nl oc pl pt_BR pt ro ru sv th tr uk vi zh_CN zh_HK zh_TW
aspell	be ca cs da de en_GB es fr ga it mn nl pt_BR ro ru rw sk sl sr sv tg uk vi wa
asunder	ar be@latin bg bn_IN bs_BA ca cs da de el eo es eu fi fr gl he hr hu it ja lv nb nl nn pl pt_BR pt ru sk sl sq sr@latin sr sv tr ur_PK zh_CN zh_TW
atk	af am an ar as ast az be@latin be bg bn_IN bn bs ca ca@valencia cs cy da de dz el en_CA en_GB en@shaw eo es et eu fa fi fr ga gl gu he hi hr hu hy id is it ja ka kk km kn ko ku li lt lv mai mk ml mn mr ms nb ne nl nn oc or pa pl ps pt_BR pt ro ru rw si sk sl sq sr@ije sr@latin sr sv ta te tg th tk tr tt ug uk vi wa xh yi zh_CN zh_HK zh_TW zu	atk10
at-spi2	an as ast be bg bn_IN ca ca@valencia cs da de el en_CA en_GB eo es et eu fa fi fr fur ga gl gu he hi hu id it ja km kn ko lt lv ml mr ms nb nl or pa pl pt_BR pt ro ru sk sl sq sr@latin sr sv ta te tg tr ug uk uz@cyrillic vi zh_CN zh_HK zh_TW	$P-core
attr	cs de es fr gl nl pl sv
audacious	ast be bg ca cmn cs da de el en_GB eo es_AR es es_MX et eu fa_IR fi fr gl hu id_ID it ja ko ky lt lv ml_IN ms nl pl pt_BR pt_PT ro ru si sk sq sr@latin sr ta tr uk vi zh_CN zh_TW
audacious-plugins	be bg ca cmn cs da de el en_GB es_AR es es_MX et eu fi fr gl hu id_ID it ja ko ky lt lv ml_IN pl pt_BR pt_PT ru si sk sr_RS ta tr uk zh_CN zh_TW
audacity	af ar be bg bn bs ca ca@valencia cs cy da de el es eu fa fi fr ga gl he hi hu id it ja ka km ko lt mk my nb nl oc pl pt_BR pt ro ru sk sl sr_RS@latin sr_RS sv tg tr uk vi zh zh_TW
avant-window-navigator	af ar ast az be bg bn bs ca crh csb cs cy da de dv el en_AU en_CA en_GB eo es et eu fa fi fr ga gl gu he hi hr hu id is it ja jv kab ka ko ku lt lv mk ml mn mr ms nb nds ne nl nn oc pl pt_BR pt ro ru si sk sl sq sr sv ta te th tr uk vi zh_CN zh_HK zh_TW
avidemux	bg ca cs de el es fr hu it ja pl pt_BR ru sr@latin sr tr zh_CN zh_TW
ayttm	de en_GB es fr hi nl pt_BR sv
backintime	ar bg bs ca cs da de el en_CA en_GB es et eu fi fo fr gl he hr hu id it ja jv ko lt nb nl nn pl pt_BR pt ro ru sk sl sr sv th tr uk zh_CN zh_TW
backup-manager	cs de es fr it nl vi
binutils	bg da es fi fr id it ja ro ru rw sk sv tr uk vi zh_CN zh_TW
binutils	bg da de eo es fi fr ga id it ja ms nl pt_BR ro ru rw sr sv tr uk vi	gprof
binutils	bg da es fi fr ga id it ja sv tr uk vi zh_CN zh_TW	ld
binutils	da es fi fr id ja ro ru rw sv tr uk vi zh_CN	bfd
binutils	da de es fi fr ga id it nl pt_BR ro sv tr uk vi zh_CN	opcodes
binutils	es fi fr id ja ru rw tr	gas
bison	ast da de el eo es et fi fr ga gl hr hu id it ja ky lt lv ms nb nl pl pt_BR pt ro ru sl sq sr sv th tr uk vi zh_CN zh_TW	$P-runtime
bison	da de el eo es et fi fr ga hr id it ja ms nb nl pl pt_BR pt ro ru sr sv tr uk vi zh_CN zh_TW
bittorrent	af bg ca cs da de el en es es_MX fr he hu is it ja ko nb_NO nl pl pt_BR pt ro ru sk sl sv tr vi zh_CN zh_TW
bleachbit	ar ast be bg bn bs ca cs da de el en_AU en_GB eo es et eu fi fo fr gl he hi hr hu hy ia id it ja ko ku ky lt ms my nb nds nl pl pt_BR pt ro ru se si sk sl sr sv ta te th tr ug uk uz vi zh_CN zh_TW
blender	ar bg ca cs de el es_ES es fa fi fr hr id it ja ky ne pl pt ru sr@latin sr sv tr uk zh_CN zh_TW		$US/$P/2.63/datafiles/locale/%/$LC
bluefish	bg ca cs da de el en es eu fi fr gl hu it ja ko nb nl nn pl pt_BR pt ro ru sk sr sv ta tr uk zh_CN zh_TW	$P ${P}_plugin_about ${P}_plugin_charmap ${P}_plugin_entities ${P}_plugin_htmlbar ${P}_plugin_infbrowser ${P}_plugin_snippets ${P}_plugin_zencoding
blueman	af ar bg bs ca cs da de el en_GB es fa fi fr gl he hu id it ja kk ko lt lv nb nds nl pl pt_BR pt ro ru sk sl sv sw ta tr uk vi zh_CN zh_TW
#boinc	ar be bg ca cs cy da de el es fa fi fr gl hr hu it ja ko lt lv nb nl nn pl pt_BR pt_PT ro ru sk sl sv_SE tr uk zh_CN zh_TW	BOINC-Manager	$US/locale/%
brasero	af ar as ast be bg bn_IN bn br ca ca@valencia cs da de dz el en_GB en@shaw es et eu fi fr ga gl gu he hi hu it ja kn ko ku lt lv mai mk ml mr nb nds nl oc or pa pl pt_BR pt ro ru sl sr@latin sr sv ta te th tr uk vi zh_CN zh_HK zh_TW
bygfoot	bg da de es fr it nl pl ro sv zh
cadaver	en@quot es it
cairo-clock	da de en_GB es fi fr it ja nl nn pl pt_PT ru sl sv tr zh_CN zh_TW
cairo-dock	ar be bn ca cs cy de el en es et eu fi fo fr gl hu id it ja ko nb nl oc pl pt_BR pt ro ru sk sl sr sv tr uk vi zh_CN zh_TW
cairo-dock-plugins	ar cs de el en es et eu fr hu id it ja nl pl pt_BR pt ru sk sr sv tr uk zh_CN zh_TW
caja	af am ar as ast az be@latin be bg bn_IN bn br bs ca ca@valencia cmn crh cs cy da de dz el en_AU en_CA en_GB en@shaw en_US eo es et eu fa fi fr fur fy ga gl gu gv ha he hi hr hu hy id ig io is it ja ka kk km kn ko ku ky li lt lv mai mg mi mk ml mn mr ms nb nds ne nl nn nso oc or pa pl ps pt_BR pt ro ru rw si sk sl sq sr@ije sr@latin sr sv ta te th tk tr ug uk ur uz@cyrillic uz vi wa xh yi yo zh_CN zh_HK zh_TW zu
catfish	ca cs da de es fi fr it pl ru sv zh_CN
cbrpager	es fr
cclcfox	es
cclfox	es
celestia	ar bg de el en es fr hu it ja ko lt lv nl pl pt_BR pt ro ru sv uk zh_CN	${P}_constellations
celestia	ar bg de el es fr hu it ja ko lt lv nl pl pt_BR pt ro ru sv uk zh_CN
centerim	bg cs de es fr hu it ms nl pl pt_BR ro ru sv uk zh_CN zh_TW
chemtool	bg cs de fr nl pl pt_BR pt_PT ru
cherokee	ca de en es fr gl it jp nl pl pt_BR sv_SE zh_CN
cherrytree	cs de es fr it pl ru uk zh_CN
childsplay	ar ca cs de el eo es fr hu it nb nl pl pt_BR pt ro ru sk sl sv uk vi
cinepaint	ca cs da de el en_GB es eu fi fr ga gl hr hu it ja ko lt nl nn no pl pt_BR pt ro ru sk sl sv tr uk zh_CN zh_TW	$P $P-script-fu $P-std-plugins
cinepaint	cs de eo eu fr	icc_examin_cp
claws-mail	bg ca cs de en_GB es fi fr he hu id_ID it ja lt nl pl pt_BR pt_PT ru sk sv uk zh_CN zh_TW
clipit	cs da de es_ES es et fr hu it ja nb pl pt_BR ro ru sv tr zh_CN
clisp	da de en es fr nl ru	clisplow
clisp	da de en es fr nl ru
clutter	de fr gl id it nb nl pa pl sv te uk zh_CN zh_TW	$P-1.0
cndrvcups-common	de es fr it ja	cngplp
comix	ca cs es fr hr hu id ja ko pl pt_BR ru sv zh_CN zh_TW
compiz-ccsm	ar as be bg bn_IN bn ca cs da de el en_GB es eu fa fi fr gl gu he hi hr hu id it ja ko md ml_IN nb nl or pa pl pt_BR pt ru sk sv tr wo zh_CN zh_HK	ccsm
compiz-core	af ar bg bn_IN bn bs ca cs cy da de el en_GB en_US es et eu fi fr gl gu he hi hr hu id it ja ka km ko lo lt mk mr nb nl or pa pl pt_BR pt ro ru sk sl sr sv ta tr uk vi xh zh_CN zh_TW zu	compiz
connman-ui	fr
coreutils	af be bg ca cs da de el eo es et eu fi fr ga gl hu id it ja kk ko lg lt ms nb nl pl pt_BR pt ro ru sk sl sv tr uk vi zh_CN zh_TW		$US/locale/%/$LC $US/locale/%/LC_TIME
cpio	da de es fi fr ga gl hu id ko nl pl pt_BR ro ru sv tr uk vi zh_CN zh_TW
cpufrequtils	cs de fr it pt
cream	es fr
cryptsetup	cs de fi fr id it nl pl sv uk vi
cssed	ca de es fr gl it
dar	de fr sv
davfs2	cs de
deadbeef	be bg bn ca cs da de el en_GB eo es et fa fi fr gl he hr hu id it ja kk km lg lt nb nl pl pt_BR pt ro ru si sk sl sr@latin sr sv te tr ug uk vi zh_CN zh_TW
decibel	ar bg bs ca cs da de el en_GB eo es fa fr ga he hr hu it ja kk ko nb nl nn pl pt_BR pt ro ru sl sr sv tr zh_CN	$P-audio-player
deluge	ar ast be bg bn bs ca cs cy da de el en_AU en_CA en_GB eo es et eu fa fi fo fr fy gl he hi hr hu id is it iu ja ka kk kn ko ku ky la lb lt lv mk ml ms nb nds nl nn oc pl pms pt_BR pt ro ru si sk sl sr sv ta te th tlh tl tr uk ur vi zh_CN zh_HK zh_TW	$PY/$P/i18n/%/$LC
devede	ca cs da de_DE el es fr gl hu_HU it_IT nb_NO nl pl pt_BR pt_PT ru sk sv tr zh_CN zh_TW
devilspie	de
dfc	fr
dia	am ar az be bg bs ca ca@valencia cs da de dz el en_CA en_GB es eu fi fr ga gl gu hr hu id is it ja kn ko lt lv mk ml mn mr ms nb ne nl nn oc or pa pl pt_BR pt ro ru rw sk sl sq sr@Latn sr sv ta th tr uk vi zh_CN zh_HK zh_TW
dialog	ar be@latin bg ca cs cy da de el eo es et eu fi fr ga gl hi hr hu id is it ja ku lt lv mg mk ms nb nl pl pt_BR pt rm ro ru rw sk sl sq sr sv sw th tr uk vi wa zh_CN zh_TW
diffutils	ca cs da de el eo es fi fr ga gl he hu id it ja lv ms nl pl pt_BR ro ru sr sv tr uk vi zh_CN zh_TW
duplicity	bg de el en_AU en_GB eo es fr he hu id io it oc pl pt_BR pt ru sl sq sr sv tr ug zh_CN
e2fsprogs	ca cs de es fr id it nl pl sv tr vi zh_CN
easytag	bg cs da de el es fr he hu it ja nl pl pt_BR ro ru sr@Latn sr sv uk zh_CN zh_TW
ecore	cs de el eo fr it nl pt sl zh_CN
efl	ca cs de el eo es fr gl it ja ko lt nl pl pt ru sl sr zh_CN
efreet	cs de el eo es fr it ja ko nl pt ru sl zh_CN
ekiga	am ar as az be bg bn_IN bn bs ca ca@valencia crh cs cy da de dz el en_CA en_GB eo es et eu fa fi fr ga gl gu he hi hr hu id is it ja ka kn ko ku lt lv mai mk ml mn mr ms nb ne nl nn oc or pa pl pt_BR pt ro ru rw si sk sl sq sr@latin sr sv ta te th tr uk vi wa xh zh_CN zh_HK zh_TW
elementary	ar az_IR cs de eo fa fr he it ko_KR nl ps pt ur yi zh_CN
elfutils	de en@boldquot en@quot es ja pl uk
elinks	be bg ca cs da de el es et fi fr gl hr hu id is it lt nb nl pl pt_BR pt ro ru sk sr sv tr uk
elinks-small	be bg ca cs da de el es et fi fr gl hr hu id is it lt nb nl pl pt_BR pt ro ru sk sr sv tr uk	elinks
emerald	ar bn_IN bn ca cs da de el en_GB es_AR es eu fa fi fr gl gu he hi hu it ja ko nb nl or pa pl pt_BR pt ru sk sv tr zh_CN zh_HK zh_TW
encfs	ar be bg bs ca cs da de_AT de_CH de_DE de el en_AU en_CA en_GB eo es_ES es es_PE et fi fr_FR fr gl he hi hr hu_HU hu id it ja ka ko lv mr nb nds nl nn oc pl pt_BR pt pt_PT ro ru sk sr sv ta te tr uk vi zh_CN zh_HK zh_TW
engrampa	af am ar as ast az be@latin be bg bn_IN bn br bs ca ca@valencia cmn cs cy da de dz el en_AU en_CA en_GB en@shaw eo es et eu fa fi fr fur fy ga gl gu he hi hr hu hy id is it ja ka kk kn ko ku ky lt lv mai mg mk ml mn mr ms nb nds ne nl nn oc or pa pl ps pt_BR pt ro ru rw si sk sl sq sr@ije sr@latin sr sv ta te th tk tr ug uk ur ur_PK vi xh zh_CN zh_HK zh_TW
enigma	de es fi fr hu it nl pt ru sv
enlightenment	ar bg ca cs da de el eo es et fi fo fr_CH fr gl he hr hu it ja km ko ku lt ms nb nl pl pt_BR pt ro ru sk sl sr sv tr uk zh_CN zh_TW
enlightenment-pam	ar bg ca cs da de el eo es et fi fo fr_CH fr gl he hr hu it ja km ko ku lt ms nb nl pl pt_BR pt ro ru sk sl sr sv tr uk zh_CN zh_TW	enlightenment
enna	da de el en@boldquot en@quot es fr it nl pl pt_BR ru tr uk zh_CN zh_TW
epdfview-cups	 ar ca cs de el es eu fr gl he_IL hu it ja nl_NL pl pt_BR pt_PT ru sv vi zh_CN zh_TW	epdfview
epdfview	ar ca cs de el es eu fr gl he_IL hu it ja nl_NL pl pt_BR pt_PT ru sv vi zh_CN zh_TW
evince	af ar as ast be@latin be bg bn_IN bn br ca ca@valencia cs cy da de dz el en_CA en_GB en@shaw eo es et eu fa fi fr ga gl gu he hi hu id it ja ka kk kn ko ks ku lt lv mai mg mk ml mn mr ms nb nds ne nl nn oc or pa pl ps pt_BR pt ro ru rw si sk sl sq sr@latin sr sv ta te th tr uk vi wa zh_CN zh_HK zh_TW
evolution-data-server	am ar as ast az be bg bn_IN bn bs ca ca@valencia cs cy da de dz el en_AU en_CA en_GB es et eu fa fi fr ga gl gu he hi hr hu id is it ja ka kn ko ku lt lv mai mk ml mn mr ms nb ne nl nn oc or pa pl pt_BR pt ro ru rw si sk sl sq sr@latin sr sv ta te th tr uk vi wa xh zh_CN zh_HK zh_TW	$P-2.28
exif	da de es fi fr gl id is it lv nl pl ro sk sv vi zh_CN
exiv2	de es fi fr pl ru sk
exo	ar ast be bg bn ca cs cy da de dz el en_GB es et eu fi fr gl he hr hu id is it ja ka kk ko ku lt lv mk nb nl nn pa pl pt_BR pt ro ru si sk sl sq sv tl_PH tr ug uk ur ur_PK zh_CN zh_TW	$P-1
fcitx-configtool	zh_CN
fcitx-googlepinyin	zh_CN
fcitx	zh_CN
fetchmail	ca cs da de el en_GB eo es fi fr gl id it ja nl pl pt_BR ru sk sq sv tr vi zh_CN
filezilla	an ar bg_BG ca_ES@valencia ca cs_CZ da_DK de el es et_EE eu_ES eu fa_IR fi_FI fr gl_ES he_IL hr hu_HU hy id_ID is it ja_JP ka km_KH ko_KR ku ky lt_LT lv_LV mk_MK nb_NO ne nl nn_NO oc pl_PL pt_BR pt_PT ro_RO ru sk_SK sl_SI sr sv th_TH tr uk_UA vi_VN zh_CN zh_TW
findutils	be bg ca cs da de el eo es et fi fr ga gl hr hu id it ja ko lg lt ms nl pl pt_BR pt ro ru rw sk sl sr sv tr uk vi zh_CN zh_TW
flex	ca da de es fi fr ga ko nl pl pt_BR ro ru sv tr vi zh_CN
font-manager	it ru sk
#fpc	ru	messages	$US/doc/$P-2.6.4/ncurses/examples/%
fpm2	bg cs de es eu fr hu it
freeciv	ar ca cs da de el en_GB eo es et fa fi fr he hu it ja ko lt nb nl no pl pt_BR pt ro ru sv tr uk zh_CN
freetuxtv	de fr pt zh_CN zh_TW
frozen-bubble	af bg br ca cs da de el eo es fa fi fr it ja lt nb ne nl nn pl pt_BR pt ro ru sk sl sv tr
gadmin-antivirus	sv
gadmin-bind	sv
gadmin-dhcpd	de sv
gadmin-openvpn-client	de sv
gadmin-proftpd	es fr sv zh_CN
gadmin-rsync	pl
gadmin-samba	de fr
gajim	be@latin be bg br cs da de el en_GB eo es eu fr gl hr it ja kk lt nb nl no pl pt_BR pt ru sk sr@Latn sr sv uk zh_CN
galculator	da_DK de es es_MX fr hu ja kk_KZ lt pl pt_BR pt ro ru sk sv tr zh_CN zh_TW
gammu	af bg ca cs da de el es et fi fr gl he hu id it ko nl pl pt_BR ru sk sv sw zh_CN zh_TW	$P lib$P
garcon	ar bg bn ca cs da de el en_AU en_GB eo es et eu fi fr gl he hr hu id is it ja kk ko lt lv ms nb nl nn oc pa pl pt_BR pt ro ru sk sl sq sr sv te th tr ug uk uz@Latn uz zh_CN zh_HK zh_TW
gaupol	ca de es fi he hu pl pt_BR ru sv tr
gawk	da de es fi fr it ja nl pl sv
gcc3	be ca da de el es fr ja nl rw sv tr	gcc
gcc3	de fr	libstdc++
gcc+gcj	be ca da de el es fi fr id ja nl ru sv tr uk vi zh_CN zh_TW	cpplib
gcc+gcj	be da de el es fi fr id ja nl ru sr sv tr vi zh_CN zh_TW	gcc
gcc+gcj	de fr	libstdc++
gcc	be ca da de el es fi fr id ja nl ru sv tr uk vi zh_CN zh_TW	cpplib
gcc	be da de el es fi fr id ja nl ru sr sv tr vi zh_CN zh_TW
gcc	de fr	libstdc++
gcompris	af am ar ast az bg br ca cs da de dz el en_CA en_GB eo es et eu fa fi fr ga gl gu he hi hr hu id it ja ka ko lt mk ml mr ms nb ne nl nn oc pa pl pt_BR pt ro ru rw sk sl so sq sr@latin sr sr_ME sv ta te th tr uk ur vi wa zh_CN zh_HK zh_TW zu
GConf	am ar as ast az be bg bn_IN bn bs ca ca@valencia cs cy da de dz el en_CA en_GB en@shaw eo es et eu fa fi fr ga gl gu he hi hr hu hy id is it ja ka kn ko ku lt lv mai mg mk ml mn mr ms nb ne nl nn oc or pa pl pt_BR pt ro ru rw si sk sl sq sr@latin sr sv ta te th tr ug uk vi xh yi zh_CN zh_HK zh_TW	${P}2
gdb	da es fi fr id ja ro ru rw sv tr uk vi zh_CN	bfd
gdb	da de es fi fr ga id it nl pt_BR ro sv tr uk vi zh_CN	opcodes
gdbm	de fi ja pl uk
gdb-python	da es fi fr id ja ro ru rw sv tr uk vi zh_CN	bfd
gdb-python	da de es fi fr ga id it nl pt_BR ro sv tr uk vi zh_CN	opcodes
gdk-pixbuf	af ang ar as ast az be@latin be bg bn_IN bn br bs ca ca@valencia crh csb cs cy da de dz el en_CA en_GB en@shaw eo es et eu fa fi fr ga gl gu he hi hr hu hy ia id io is it ja ka km kn ko ku li lt lv mai mi mk ml mn mr ms my nb nds ne nl nn nso oc or pa pl ps pt_BR pt ro ru si sk sl sq sr@ije sr@latin sr sv ta te th tk tr tt ug uk uz@cyrillic uz vi wa xh yi zh_CN zh_HK zh_TW
geany	ar ast be bg ca cs de el en_GB es et eu fa fi fr gl he hi hu id it ja kk ko lb lt mn nl nn pl pt_BR pt ro ru sk sl sr sv tr uk vi zh_CN zh_TW
geany-plugins	be ca da de es fr gl ja nl pt_BR pt ru tr zh_CN
gecko-mediaplayer	cs de es fr it ja nl pl pt_BR tr
geeqie	ar be bg ca cs da de eo es et eu fi fr hu id it ja ko nb nl pl pt_BR ro ru sk sl sr@latin sr sv th tr uk vi zh_CN.GB2312 zh_TW
gegl	es fr pl ru sl	$P-0.2
gejengel	es nl
gettext	be bg ca cs da de el en@boldquot en@quot es et fi fr gl id it ja ko nb nl nn pl pt_BR pt ro ru sk sl sr sv tr uk vi zh_CN zh_TW	$P-runtime $P-tools
gettext	eo ga hr zh_HK	$P-runtime
gettext	eu pa	$P-tools
gftp	am ar az be bg bn ca cs da de dz el en_CA en_GB es fi fr ga gl gu he hr hu it ja ko lt lv mk ml ms nb ne nl oc pa pl pt_BR pt ro ru rw sk sq sr@Latn sr sv ta th tr uk zh_CN zh_HK zh_TW
ghex	am ar az be bg ca cs da de dz el en_CA en_GB es et eu fi fr ga gl hr hu id it ja ko lv mk ml ms nb ne nl nn oc pa pl pt_BR pt ro ru rw sk sl sq sr@Latn sr sv tr uk vi wa zh_CN zh_TW	$P-2.0
giac	de el en es fr it pt zh
gigolo	ast bg ca cs da de el es eu fi fr gl hr hu id it ja kk lv nl pl pt_BR pt ru sk sv tr ug uk ur ur_PK zh_CN
gimp	ar be bg br ca ca@valencia cs da de dz el en_CA en_GB eo es et eu fa fi fr gl gu hr hu id is it ja km ko lt lv mk ms my nb ne nl nn pa pl pt_BR pt ro ru rw sk sl sr@latin sr sv tr uk vi zh_CN zh_HK zh_TW	gimp20 gimp20-libgimp gimp20-python gimp20-script-fu gimp20-std-plug-ins gimp20-tips
gimp	he ta	gimp20 gimp20-libgimp gimp20-script-fu gimp20-tips
gimp	ga oc xh	gimp20-python gimp20-std-plug-ins gimp20 gimp20-libgimp gimp20-script-fu
gimp	az te	gimp20-python gimp20 gimp20-libgimp gimp20-script-fu
gimp	ta	gimp20-python
gimp	he kn yi	gimp20-std-plug-ins
gimp	am ast csb ga hi ka kk kn ml nds oc si th tt xh yi	gimp20
gimp	kk yi	gimp20-libgimp
gimp	yi	gimp20-script-fu
git	bg de fr is it pt_PT sv vi zh_CN
glade3	ar ast az bg bn_IN bn ca ca@valencia cs da de el en_CA en_GB en@shaw eo es et eu fi fr gl gu he hi hu hy id it ja ko lt lv mai mk ml mr ms nb nl nn oc or pa pl pt_BR pt ro ru si sk sl sq sr@latin sr sv ta te th tr ug uk vi zh_CN zh_HK zh_TW
glances	es fr it pt_BR
glibc	be bg ca cs da de el en_GB es fi fr gl hr hu id it ja ko lt nb nl pl pt_BR ru rw sk sv tr vi zh_CN zh_TW	libc
glib	af am an ar as ast az be@latin be bg bn_IN bn bs ca ca@valencia cs cy da de dz el en_CA en_GB en@shaw eo es et eu fa fi fr ga gl gu he hi hr hu hy id is it ja ka kk kn ko ku lt lv mai mg mk ml mn mr ms nb nds ne nl nn oc or pa pl ps pt_BR pt ro ru rw si sk sl sq sr@ije sr@latin sr sv ta te tg th tl tr tt ug uk vi wa xh yi zh_CN zh_HK zh_TW	glib20
glib-networking	an ar as be bg bn_IN ca ca@valencia cs da de el en_CA en_GB eo es et eu fa fi fr fur gl gu he hi hu id it ja km kn ko lt lv ml mr nb nl or pa pl pt_BR pt ro ru sk sl sr@latin sr sv ta te tg th tr ug uk vi zh_CN zh_HK zh_TW
gliv	bg cs da de fi fr nl pl pt_BR ro ru rw sk sv tr vi
gmerlin	de
gmpc	ar bg bn bs cs da de el en_CA en_GB es et fi fr gl he hi hu hy id it ja jv lv ml ms nb ne nl oc pl pt_BR pt ro ru sq sv th tr zh_CN zh_TW
gmtp	da de en_AU es fr it ru
gnomad2	ca cs_CZ de es fi fr it nb nl pl sco sv
gnome-calculator	af am ar as ast az be@latin be bg bn_IN bn bs ca ca@valencia cs cy da de dz el en_CA en_GB en@shaw en_US eo es et eu fa fi fr ga gl gu he hi hr hu hy id it ja ka kk km kn ko ku lt lv mai mg mk ml mn mr ms my nb ne nl nn oc or pa pl pt_BR pt ro ru rw si sk sl sq sr@latin sr sv ta te tg th tk tr ug uk vi xh zh_CN zh_HK zh_TW
gnome-commander	ar bg ca cs de dz el en_CA en_GB eo es eu fi fr ga hr hu it ja ko nb ne nl oc pa pl pt_BR pt ro ru rw sk sl sq sr@Latn sr sv uk vi zh_CN zh_TW
gnome-desktop	af am ar as ast az be@latin be bg bn_IN bn br bs ca ca@valencia crh cs cy da de dz el en_CA en_GB eo es et eu fa fi fr fur ga gl gu he hi hr hu hy id ig is it ja ka kk kn ko ku ky li lo lt lv mai mg mi mk ml mn mr ms nb nds ne nl nn nso oc or pa pl ps pt_BR pt ro ru rw si sk sl sq sr@latin sr sv ta te th tk tr ug uk ur uz@cyrillic uz vi wa xh yi yo zh_CN zh_HK zh_TW zu	$P-2.0
gnome-doc-utils	ar as ast be@latin be bg bn_IN bn ca ca@valencia cs cy da de dz el en_CA en_GB en@shaw eo es et eu fa fi fr ga gl gu he hi hu id it ja ka km kn ko lt lv mai mg mk ml mn mr nb ne nl nn oc or pa pl pt_BR pt ro ru rw sk sl sq sr@latin sr sv ta te th tr ug uk uz@cyrillic uz vi wa zh_CN zh_HK zh_TW
gnome-games	af am ar as ast az be bg bn_IN bn br ca ca@valencia cs cy da de dz el en_CA en_GB en@shaw eo es et eu fa fi fr ga gl gu he hi hr hu id is it ja ka kk kn ko ku lt lv mai mk ml mn mr ms nb ne nl nn oc or pa pl pt_BR pt ro ru rw si sk sl sq sr@latin sr sv ta te th tr uk vi wa xh zh_CN zh_HK zh_TW
gnome-hearts	da de el en_GB es eu fi fr hu id it ml nl pl pt_BR pt ru sk sv tl zh_CN
gnome-keyring	ar as ast az be@latin be bg bn_IN bn bs ca ca@valencia cs cy da de dz el en_CA en_GB en@shaw es et eu fa fi fr ga gl gu he hi hr hu id is it ja ka kn ko lt lv mai mg mk ml mn mr ms nb ne nl nn oc or pa pl pt_BR pt ro ru rw si sk sl sq sr@latin sr sv ta te th tr uk vi xh zh_CN zh_HK zh_TW
gnome-menus	af an ar as ast be@latin be bg bn_IN bn br ca ca@valencia crh cs cy da de dv dz el en_CA en_GB en@shaw eo es et eu fa fi fr fur ga gl gn gu ha he hi hr hu hy id ig io is it ja ka kk kn ko ku ky lt lv mai mg mk ml mn mr ms nb nds ne nl nn oc or pa pl ps pt_BR pt ro ru rw si sk sl sq sr@latin sr sv ta te th tr ug uk uz@cyrillic vi xh yo zh_CN zh_HK zh_TW
gnome-mime-data	af am ar az be bg bn bs ca cs cy da de el en_CA en_GB eo es et eu fa fi fr ga gl gu he hi hr hu id is it ja ko li lt lv mk ml mn ms nb ne nl nn nso pa pl pt_BR pt ro ru rw sk sl sq sr@ije sr@Latn sr sv ta th tk tr uk vi wa xh yi zh_CN zh_TW zu
gnome-mplayer	ar bg ca cs da de el en_GB es et eu fi fo fr fy gl he hr hu id it ja ko lt nl pl pt_BR pt ro ru si sr@latin sr sv th tr ug uk zh_CN zh_HK zh_TW
gnome-ppp	be ca cs de es fr it mk pl pt_BR ru sr@Latn sr sv tr vi
gnome-vfs	af am ar as ast az be bg bn_IN bn bs ca ca@valencia cs cy da de dz el en_CA en_GB en@shaw eo es et eu fa fi fr ga gl gu he hi hr hu id is it ja ka kn ko ku li lt lv mai mg mk ml mn mr ms nb ne nl nn nso oc or pa pl pt_BR pt ro ru rw sk sl sq sr@ije sr@latin sr sv ta te th tr uk uz@cyrillic uz vi wa xh yi zh_CN zh_HK zh_TW zu	$P-2.0
gnucash	ar bg ca cs da de el en_GB es es_NI eu fa fi fr he hu it ja ko lt lv nb ne nl pl pt_BR pt ro ru rw sk sv ta tr uk vi zh_CN zh_TW
gnumeric	am ar ast az bg ca ca@valencia cs da de dz el en_CA en_GB es et eu fi fr ga gl gu he hr hu id it ja kk ko lt lv mk ml mr ms nb ne nl nn oc pl pt_BR pt ro ru rw sk sl sr@latin sr sv te tr uk vi zh_CN zh_TW	$P $P-functions
gnu-netcat	it sk	netcat
gnupg	be ca cs da de el en@boldquot en@quot eo es et fi fr gl hu id it ja nb pl pt_BR pt ro ru sk sv tr uk zh_CN zh_TW	${P}2
gnutls	cs de en@boldquot en@quot fr it ms nl pl sv vi zh_CN	lib$P
gobby	ca cs de el en_GB es fr he it ja ko nl pl pt_BR pt ru sv uk zh_CN
goffice	am ar ast az bg ca ca@valencia cs da de el en_CA en_GB es et eu fi fr ga gl he hr hu it ja ko lt lv ml mr ms nb nl nn oc pl pt_BR pt ro ru sk sl sr@latin sr sv tr uk vi zh_CN zh_HK zh_TW	$P-0.8.17
gogglesmm	cs de es fr hu pt ru
goocanvas	en_GB es ja
gpa	ar cs de es fr ja nl pl pt_BR ru sv tr zh_TW.Big5
gparted	ar bg br ca ca@valencia cs da de dz el en_CA en_GB eo es et eu fa fi fr gd gl gu he hu id is it ja kk ko lt lv mk ml nb ne nl nn oc pa pl pt_BR pt ro ru rw si sk sl sr@latin sr sv te th tr uk vi zh_CN zh_HK zh_TW
gphoto2	az cs da de en_GB es eu fi fr hu id it ja nl pa pl pt_BR ro ru rw sk sr sv uk vi zh_CN zh_TW
#gpick	es lt ru		/share/locale/%/$LC
gpicview	af ar bg bn_IN bn ca cs da de el es es_VE et eu fa fi fr frp gl he hr hu id it ja ko lt ml ms nb nl nn pl ps pt_BR pt ru sk sl sr sv th tr uk ur ur_PK vi zh_CN zh_TW
gpodder	ca cs_CZ cs da de el es_ES es es_MX eu fa_IR fi fr gl he id_ID it kk nb nl nn pl pt_BR pt ro ru sv tr tr_TR uk zh_CN
gqview	ar be bg ca cs da de eo es et eu fi fr hu id it ja ko nl no pl pt_BR ro ru sk sl sv th tr uk vi zh_CN.GB2312 zh_TW
granite	af am ar be bg bs ca cs da de el en_AU en_CA en_GB eo es et eu fa fi fr_CA fr fy gl he hi hu id it ja ko lb lt lv ms nl nn pl pt_BR pt ro rue ru sk sl sma sr sv te tr uk vi zh_CN zh_TW
graveman	cs de es fr hu it ja lt nl no pl pt_BR ru sv
grep	af be bg ca cs da de el eo es et eu fi fr ga gl he hr hu id it ja ko ky lt nb nl pl pt_BR pt ro ru sk sl sr sv th tr uk vi zh_CN zh_TW
grisbi	cs da de el eo es fa fr he it lv nl pl pt_BR ro ru sv zh_CN
grsync	ca_ES cs_CZ de_DE es_ES fr_FR gl_ES hr_HR id_ID it_IT nb_NO nl_NL pt_BR ru_RU sv_SE tr_TR zh_CN
grub2	 ast ca da de_CH de@hebrew de en@arabic en@cyrillic en@greek en@hebrew en@piglatin en@quot eo fi fr hu id it ja nl pa pl ru sv uk vi zh_CN zh_TW	grub
gsasl	en@boldquot en@quot fr ga id nl pl ro sr sv vi zh_CN	$P lib$P
gsasl	de eu sq zh_TW	$P
gsasl	sk	lib$P
gsettings-desktop-schemas	as bg ca ca@valencia cs da de el en_GB eo es eu fi fr gl gu he hi hu id it ja lt lv ml nb or pa pl pt_BR pt ru sk sl sr@latin sr sv tg ug uk vi zh_CN zh_HK zh_TW
gst-plugins-bad	af az bg ca cs el en_GB eo eu fi gl hu ja ky lt lv mt nb nl or pl ro sk sl sq sr sv tr uk vi	$P-0.10
gst-plugins-base-1.0	af az bg ca cs da de el en_GB eo es eu fi fr gl hr hu id it ja lt lv nb nl or pl pt_BR ro ru sk sl sq sr sv tr uk vi zh_CN
gst-plugins-base	af az bg ca cs el en_GB eo eu fi gl hu ja lt lv nb nl or pl ro sk sl sq sr sv tr uk vi	$P-0.10
gst-plugins-good	af az bg ca cs da de el en_GB eo es eu fi fr gl hu id it ja lt lv mt nb nl or pl pt_BR ro ru sk sl sq sr sv tr uk vi zh_CN zh_HK zh_TW	$P-0.10
gst-plugins-ugly	af az bg ca cs el en_GB eo eu fi gl hu ja lt lv ms mt nb nl or pl ro sk sl sq sr sv tr uk vi	$P-0.10
gstreamer-1.0	af az be bg ca cs da de el en_GB eo es eu fi fr gl hr hu id it ja lt nb nl pl pt_BR ro ru rw sk sl sq sr sv tr uk vi zh_CN zh_TW
gstreamer	af az be bg ca cs el en_GB eo eu fi gl hu ja lt nb nl pl ro rw sk sl sq sr sv tr uk vi zh_TW	$P-0.10
gsynaptics	ar el es fr hu ja nb pl ru zh_CN zh_TW
gtick	af ca cs da de en@boldquot en@quot es eu fi fr ga it ko nl pl pt_BR ro ru sk sv uk vi zh_CN
gtk+3	af am ang ar as ast az_IR az be@latin be bg bn_IN bn br bs ca ca@valencia crh cs cy da de dz el en_CA en_GB en en@shaw eo es et eu fa fi fr ga gl gu he hi hr hu hy ia id io is it ja ka kg kk kn ko ku lg li lt lv mai mi mk ml mn mr ms my nb nds ne nl nn nso oc or pa pl ps pt_BR pt ro ru rw si sk sl sq sr@ije sr@latin sr sv ta te th tk tr tt ug uk ur uz@cyrillic uz vi wa xh yi zh_CN zh_HK zh_TW	gtk30 gtk30-properties
gtkballs	de fr pl ru
gtk+	af am ang ar as ast az_IR az be@latin be bg bn_IN bn br bs ca ca@valencia crh cs cy da de dz el en_CA en_GB eo es et eu fa fi fr ga gl gu he hi hr hu hy ia id io is it ja ka kk kn ko ku li lt lv mai mi mk ml mn mr ms my nb nds ne nl nn nso oc or pa pl ps pt_BR pt ro ru rw si sk sl sq sr@ije sr@latin sr sv ta te th tk tr tt ug uk ur uz@cyrillic uz vi wa xh yi zh_CN zh_HK zh_TW	gtk20 gtk20-properties
gtklp	ca_ES ca chs cht cz de dk en es fr hu it ja nl pl pt_BR ru uk_UA zh_CN zh_TW
gtkpod	ca de es fr he it ja ro ru sv zh_CN
gtk-recordmydesktop	ar ca de el es fr it ja nl pl pt_BR pt ru sv tr	gtk-recordMyDesktop
gtk-screenshot	fr ru
gtksourceview	ar as ast az be bg bn_IN bn bs ca ca@valencia cs cy da de dz el en_CA en_GB en@shaw es et eu fa fi fr ga gl gu he hi hr hu id it ja kn ko lt lv mai mg mk ml mn mr ms nb ne nl nn oc or pa pl pt_BR pt ro ru rw si sk sl sq sr@latin sr sv ta te th tr uk vi xh zh_CN zh_HK zh_TW	$P-2.0
gtkspell	af be cs da de el eo es eu fi fr ga gl hu hy id it ja ky lt lv mn ms nb nl pl pt_BR pt rm ro ru rw sk sl sq sr sv th tr uk vi wa zh_CN zh_HK zh_TW
gtk-vnc	ca ca@valencia cs da de el en_GB es eu fr gl hu it ja nb nds pa pl pt_BR pt ro ru sl sv th zh_CN zh_HK zh_TW
gucharmap	af am ar as ast az be@latin be bg bn_IN bn br bs ca ca@valencia cs cy da de dz el en_CA en_GB en@shaw eo es et eu fa fi fr ga gl gu he hi hr hu id is it ja ka kn ko lt lv mai mi mk ml mn mr ms nb ne nl nn oc or pa pl pt_BR pt ro ru rw si sk sl sq sr@latin sr sv ta te th tr ug uk vi wa xh zh_CN zh_HK zh_TW
gummi	ar ca cs da de el es fr it nl pl pt_BR pt ro ru sv zh_TW
gutenprint	cs da de el en_GB es fi fr gl hu it ja nb nl pl pt ru sk sl sv uk zh_CN zh_TW
guvcview	bs cs da de es eu fo fr gl he hr it ja nl pl pt_BR pt ru sr tr uk zh_TW
gvfs	af ar as ast be@latin be bg bn_IN bn ca ca@valencia cs da de el en_GB en@shaw eo es et eu fa fi fr ga gl gu he hi hu id it ja kk kn ko ku lt lv mai mk ml mr nb nds nl nn or pa pl pt_BR pt ro ru sk sl sq sr@latin sr sv ta te th tr ug uk vi zh_CN zh_HK zh_TW
gvim	af ca cs de en_GB eo es fi fr ga it ja ko ko.UTF-8 nb no pl pt_BR ru sk sv uk vi zh_CN zh_CN.UTF-8 zh_TW zh_TW.UTF-8	vim	$US/vim/vim73/lang/%/$LC
gvolwheel	ru
gweled	ar de es fi fr he hr it ja ka ms nl pl pt_BR ru sl tr uk
gxine	cs de es fi fr it ja pl ru sv uk zh_CN	$P $P.theme
gyrus	ar ca cs dz en_CA en_GB es fi fr hu nb nl oc pt_BR sv uk vi zh_CN
h8300-gdb	da es fi fr id ja ro ru rw sv tr vi zh_CN	bfd
h8300-gdb	da de es fi fr ga id nl pt_BR ro sv tr vi zh_CN	opcodes
hexchat	af am ast az be bg ca cs da de el en_GB es et eu fi fr gl gu hi hu id it ja kn ko lt lv mk ml ms nb nl no pa pl pt_BR pt ru rw sk sl sq sr sv th uk vi wa zh_CN zh_TW
hexchat-plugin	af am ast az be bg ca cs da de el en_GB es et eu fi fr gl gu hi hu id it ja kn ko lt lv mk ml ms nb nl no pa pl pt_BR pt ru rw sk sl sq sr sv th uk vi wa zh_CN zh_TW	hexchat
homebank	am ar ast be bg br bs ca cs da de el en_AU en_CA en_GB es et eu fa fi fr gl he hr ht hu id is it ja ka kk kn ko lt lv mi ml ms nb nds nl oc pl pt_BR pt pt_PT ro ru sk sl sn sr sv ta th tr uk ur uz vi zh_CN zh_HK zh_TW
ibus-hangul	ko zh_CN
ibus	ar as bn_IN ca da de en_GB es fa fr gu hi hu it ja kn ko lv ml mr nl or pa pl pt_BR ru sr@latin sr ta te tg uk vi zh_CN zh_HK zh_TW	ibus10
icewm	be bg ca cs da de el en es fi fr hr hu id it ja ko lt lv mk nb nl pl pt_BR ro ru sk sl sv tr uk vi zh_CN zh_TW
icoutils	en@boldquot en@quot
imagination	en_GB it sl_SI
indent	ca da de eo et fi fr gl hu it ja ko nl pl pt_BR ru sk sv tr zh_TW.Big5
inkscape	am ar az be bg bn br ca ca@valencia cs da de dz el en_AU en_CA en_GB en_US@piglatin eo es es_MX et eu fa fi fr ga gl he hr hu hy id it ja km ko lt mk mn nb ne nl nn pa pl pt_BR pt ro ru rw sk sl sq sr@latin sr sv te_IN th tr uk vi zh_CN zh_TW
iso-codes	af am ar as ast az be bg bn_IN bn br bs byn ca crh cs cy da de dz el eo es et eu fa fi fo fr ga gez gl gu haw he hi hr hu hy ia id is it ja ka kk km kn ko ku lt lv mi mk ml mn mr ms mt nb ne nl nn nso oc or pa pl ps pt_BR pt ro ru rw si sk sl so sq sr@latin sr sv sw ta te th tig ti tk tl tr tt ug uk ve vi wa wal wo xh zh_CN zh_HK zh_TW zu	iso_3166
iso-codes	af am ar ast az bg bn br bs byn ca crh cs cy da de el eo es et eu fa fi fr ga gez gl gu he hi hr hu id is it ja kn kok ko lt lv mi mk mn mr ms mt nb nl nn nso oc or pa pl ps pt_BR pt ro ru rw sk sl sr@latin sr sv ta th tig ti tr tt uk ve vi wa xh zh_CN zh_TW zu	iso_639_3
iso-codes	af am ar as ast az be bg bn br bs byn ca crh cs cy da de el eo es et eu fa fi fr ga gez gl gu he hi hr hu id is it ja kn kok ko lt lv mi mk ml mn mr ms mt nb nl nn nso oc or pa pl ps pt_BR pt ro ru rw sk sl sr@latin sr sv ta te th tig ti tr tt uk ve vi wa xh zh_CN zh_HK zh_TW zu	iso_639
iso-codes	ar bg br ca cs da de el eo es et fa fi fr gl he hu ia id is it ja ko lt lv ml nb nl nn oc pl pt_BR pt ro ru sk sl sr@latin sr sv th tr uk vi zh_CN zh_HK zh_TW	iso_15924
iso-codes	az bg bs ca crh cs da de el en eo es eu fi fr ga hu id it ja ko lt lv nl nso oc pl ro sk sl sr@latin sr sv th tr uk ve vi wa zh_CN zh_TW	iso_3166_2
iso-codes	br ca cs da de el es et fi fr ga gl hr hu id is it ja ko lt lv mn nb nl nn oc pl pt_BR pt ro ru rw sk sl sr@latin sr sv th tr uk vi zh_CN zh_HK zh_TW	iso_4217
isomaster	ar be@latin bg bn_IN ca cs da de el es et fi fo fr gl he hr hu id it ja lt lv nb nl nn pl pt_BR pt ro ru sk sl sq sr@latin sr@Latn sr sv tr uk ur_PK zh_CN zh_TW
ivman	fr
json-glib	pl	$P-1.0
jwm	de es fr it nl pl pt-PT ru
kbd	cs da de el eo es fr gr id it nl pl ro ru sv tr uk vi zh_CN
kino	be ca cs da de es eu fi fr hu it nb no ru sl sv uk zh_TW
klavaro	bn cs da de en_GB eo es fr hu nl pl pt_BR ru sv ur vi
krb5	en_US	mit-$P
l3afpad	bg br ca cs da de el eo es et eu fi fr ga gl he hu id it ja ko lt lv nl nn pl pt_BR pt ru sk sl sr sv ta tr uk vi zh_CN zh_TW
labyrinth	ca cs de es eu fa fr it nl pl pt_BR pt_PT ru sv zh_CN
lbreakout2	de fr
lcdnurse	es fr he nl pt_BR ru th tr zh_CN		$US/$P/locale/%/$LC
lcdnurse	es fr nl pt_BR ru tr zh_CN	wxstd	$US/$P/locale/%/$LC
leafpad	bg br ca cs da de el eo es eu fi fr ga gl he hu id it ja ko lt lv nl nn pl pt_BR pt ru sk sl sr sv ta tr uk vi zh_CN zh_TW
lftp	cs de es fr it ja ko pl pt_BR ru zh_CN zh_HK zh_TW
libbonobo	am ar as ast az be bg bn_IN bn br bs ca ca@valencia cs cy da de dz el en_CA en_GB en@shaw eo es et eu fa fi fr ga gl gu he hi hr hu hy id is it ja ka kn ko ku li lt lv mai mg mk ml mn mr ms nb ne nl nn oc or pa pl pt_BR pt ro ru rw sk sl sq sr@latin sr sv ta te th tr ug uk vi wa xh yi zh_CN zh_HK zh_TW	$P-2.0
libbonoboui	af am ar as ast az be bg bn_IN bn br bs ca ca@valencia cs cy da de dz el en_CA en_GB en@shaw es et eu fa fi fr ga gl gu he hi hr hu id is it ja ka kn ko ku li lt lv mai mg mk ml mn mr ms nb ne nl nn nso oc or pa pl ps pt_BR pt ro ru rw si sk sl sq sr@ije sr@latin sr sv ta te th tr uk vi wa xh yi zh_CN zh_HK zh_TW zu	$P-2.0
libconfuse	fr sv	confuse
libexif	be bs cs da de en_CA en_GB es fr it ja nl pl pt_BR pt ru sk sq sr sv tr vi zh_CN	$P-12
libextractor	de fr ga nl ro rw sv vi
libfm	af ar be bg bn_IN bn ca cs da de el en_GB es et eu fa fi fo fr gl he hr hu id is it ja kk ko lg lt ml ms nb nl nn pa pl ps pt_BR pt ro ru sk sl sr@latin sr sv te th tr tt_RU ug uk ur ur_PK vi zh_CN zh_TW
libgnomecanvas	am ang ar as ast az be bg bn_IN bn br bs ca ca@valencia crh cs cy da de dz el en_CA en_GB en@shaw eo es et eu fa fi fr ga gl gu he hi hr hu id is it ja ka kn ko ku li lt lv mai mg mk ml mn mr ms nb ne nl nn oc or pa pl pt_BR pt ro ru rw sk sl sq sr@ije sr@latin sr sv ta te th tr tt ug uk vi wa xh yi zh_CN zh_HK zh_TW	$P-2.0
libgnome	am ar as ast az be bg bn_IN bn br bs ca ca@valencia crh cs cy da de dz el en_CA en_GB en@shaw eo es et eu fa fi fr fur ga gl gu he hi hr hu id is it ja ka kn ko ku lt lv mai mg mk ml mn mr ms nb nds ne nl nn oc or pa pl pt_BR pt ro ru rw si sk sl sq sr@ije sr@latin sr sv ta te th tr tt uk vi wa xh yi zh_CN zh_HK zh_TW	$P-2.0
libgnome-keyring	ar ast bg bn ca ca@valencia cs da de el en_GB eo es et eu fi fr gl he hu id it ja ko lt lv ml mn ms nb nds nl nn pa pl pt_BR pt ro ru sk sl sr@latin sr sv ta th uk zh_CN zh_HK zh_TW
libgnomeprint	am ar as ast az be@latin be bg bn_IN bn br bs ca ca@valencia cs cy da de dz el en_CA en_GB en@shaw es et eu fa fi fr ga gl gu he hi hr hu id is it ja ka kn ko ky lt lv mai mk ml mn mr ms nb nds ne nl nn oc or pa pl ps pt_BR pt ro ru rw si sk sl sq sr@latin sr sv ta te th tr uk vi wa xh zh_CN zh_HK zh_TW	$P-2.2
libgnomeprintui	af am ar as ast az be@latin be bg bn_IN bn br bs ca ca@valencia cs cy da de dz el en_CA en_GB en@shaw es et eu fa fi fr fur ga gl gu he hi hr hu id is it ja ka kn ko la li lt lv mai mk ml mn mr ms nb nds ne nl nn oc or pa pl ps pt_BR pt ro ru rw si sk sl sq sr@latin sr sv ta te th tr uk vi wa xh zh_CN zh_HK zh_TW	$P-2.2
libgnomeui	af am ar as ast az be@latin be bg bn_IN bn br bs ca ca@valencia crh cs cy da de dz el en_CA en_GB en@shaw eo es et eu fa fi fr fur ga gl gu he hi hr hu hy id is it ja ka kk kn ko ku la lg li lt lv mai mg mi mk ml mn mr ms nb nds ne nl nn nso oc or pa pl ps pt_BR pt ro ru rw si sk sl sq sr@ije sr@latin sr sv ta te th tk tr tt ug uk uz@cyrillic vi wa xh yi zh_CN zh_HK zh_TW zu	$P-2.0
libgpg-error	cs de fr it nl pl ro sv vi zh_CN
libgphoto2	cs da de es eu fr it ja nl pl pt_BR ru sk sv uk vi zh_CN zh_TW	${P}_port-0
libgphoto2	da de es eu fr hu it ja nl pl ru sv uk vi zh_CN	$P-2
libgpod	de es fr he it ja ro sv zh_CN
libgsf	ca cs da de en_GB es eu fr gl it nb oc pa pl pt_BR pt sl sv zh_CN zh_HK zh_TW
libgtop	am ar as ast az be bg bn_IN bn bs ca ca@valencia cs cy da de dz el en_CA en_GB en@shaw eo es et eu fa fi fr ga gl gu he hi hr hu id it ja ka kn ko ku ky la lt lv mai mg mi mk ml mn mr ms nb ne nl nn oc or pa pl pt_BR pt ro ru rw sk sl sq sr@latin sr sv ta te th tr ug uk vi xh zh_CN zh_HK zh_TW	$P-2.0
libhangul	ko
libidn	cs da de en@boldquot en@quot eo fi fr id it ja nl pl ro sr vi zh_CN
libquicktime	de
libwebkit	ar bg cs de el en_CA en_GB eo es et eu fr gl gu he hu id it ko lt lv mr nb nl pa pl pt_BR pt ru sl sr@latin sr sv uk vi zh_CN	webkit-2.0
libwebkit-video	ar bg cs de el en_CA en_GB eo es et eu fr gl gu he hu id it ko lt lv mr nb nl pa pl pt_BR pt ru sl sr@latin sr sv uk vi zh_CN	webkit-2.0
libwnck	am ar as ast az be@latin be bg bn_IN bn br bs ca ca@valencia crh cs cy da de dz el en_CA en_GB en@shaw eo es et eu fa fi fr ga gl gu he hi hr hu id is it ja ka kk kn ko ku ky li lt lv mai mi mk ml mn mr ms nb ne nl nn oc or pa pl pt_BR pt ro ru rw si sk sl sq sr@latin sr sv ta te th tr ug uk vi wa xh zh_CN zh_HK zh_TW
libxfce4ui	am ar ast bg bn ca cs da de el en_AU en_GB es eu fi fr gl he hr hu id is it ja kk ko lt lv ms nb nl nn oc pa pl pt_BR pt ro ru si sk sl sr sv te th tr ug uk ur ur_PK vi zh_CN zh_HK zh_TW
libxfce4util	am ar ast bg bn ca cs da de el en_AU en_GB es et eu fi fr gl he hu id is it ja kk ko lt lv ms nb nl nn oc pa pl pt_BR pt ro ru si sk sq sr sv th tr ug uk ur ur_PK uz zh_CN zh_HK zh_TW
libxfcegui4	am ar ast be bn_IN ca cs cy da de dz el en_GB eo es et eu fa fi fr gl gu he hr hu hy id is it ja ka kk ko ku lt lv mk mr nb nl nn pa pl pt_BR pt ro ru si sk sq sv ta te tl_PH tr ug uk ur ur_PK zh_CN zh_TW
libxfconf	ar ast bn ca cs da de el en_GB es eu fi fr gl he hr hu id is it ja kk ko lt lv nb nl nn pa pl pt_BR pt ro ru si sk sv te tr ug uk ur ur_PK zh_CN zh_TW	xfconf
liferea	ar ast be@latin bg ca cs da de el es eu fi fr gl he hu it ja ko lt lv mk nl pl pt_BR pt ro ru sk sq sv tr uk vi zh_CN zh_TW
lightdm-gtk2-greeter	ar ast be bg bn bo br bs ca ca@valencia cs da de el en_AU en_CA en_GB eo es et eu fi fr fy gd gl he hi hr hu ia id it ja kk km ko ku lb lt lv mhr ml ms nb nl nn oc pl pt_BR pt ro ru sd si sk sl sq sr sv ta te th tr ug uk uz vi wae zh_CN zh_HK zh_TW	lightdm-gtk-greeter
lightdm-gtk3-greeter	ar ast be bg bn bo br bs ca ca@valencia cs da de el en_AU en_CA en_GB eo es et eu fi fr fy gd gl he hi hr hu ia id it ja kk km ko ku lb lt lv mhr ml ms nb nl nn oc pl pt_BR pt ro ru sd si sk sl sq sr sv ta te th tr ug uk uz vi wae zh_CN zh_HK zh_TW	lightdm-gtk-greeter
lightdm	af an ar ast az be bg bn bo br bs ca ca@valencia cs da de el en_AU en_CA en_GB eo es et eu fa fi fo fr fy gd gl gu he hi hr hu ia id is it ja kk km kn ko ku lb lt lv mhr mi ml mr ms my nb nl nn oc pa pl pt_BR pt ro ru sc sd shn si sk sl sq sr sv ta te th tl tr ug uk uz vi wae zh_CN zh_HK zh_TW
lightdm-qt	af an ar ast az be bg bn bo br bs ca ca@valencia cs da de el en_AU en_CA en_GB eo es et eu fa fi fo fr fy gd gl gu he hi hr hu ia id is it ja kk km kn ko ku lb lt lv mhr mi ml mr ms my nb nl nn oc pa pl pt_BR pt ro ru sc sd shn si sk sl sq sr sv ta te th tl tr ug uk uz vi wae zh_CN zh_HK zh_TW	lightdm
lingot	ca cs de es gl it pt_BR sv zh_CN
linphone	cs de es fr hu it ja nb_NO nl pl pt_BR ru sv zh_CN zh_TW
linphone	cs de es fr hu it ja nl pl pt_BR ru sv zh_CN	mediastreamer
lives	ar ca cs da de_DE en_GB es et fi fr gl he hr hu it ja nl_NL oc pl pt_BR pt ro ru sk te tr uk uz zh_CN
loqui	ja
lostirc	da fr
lshw	fr
lxappearance	ar be bg cs da de el en_GB es et eu fa fi fo fr gl he hr hu id is it ja kk ko lg lt nl pa pl pt_BR pt ro ru sl sr@latin sr sv te tr tt_RU ug uk ur ur_PK vi zh_CN zh_TW
lxappearance-obconf	ar be bg bn_IN cs da de el en@boldquot en_GB en@quot es et eu fa fi fo fr gl he hr hu id it ja kk ko lg lt nb nl pl pt_BR pt ro ru sl sr@latin sr sv te tr tt_RU ug uk vi zh_CN zh_TW
lxdm	af ar bg bn_IN ca cs da de el es es_VE et eu fa fi fr frp gl he hr hu id it ja ko lt ml ms nb nl nn pl ps pt_BR pt ru sk sl sr sv tr uk ur ur_PK vi zh_CN zh_TW
lxinput	af ar ast be bg bn_IN bn ca cs da de el en_GB eo es es_VE et eu fa fi fo fr frp gl he hr hu id it ja kk ko lg lt ml ms nb nl nn pl ps pt_BR pt ro ru si sk sl sr@latin sr sv te th tr tt_RU ug uk ur ur_PK vi zh_CN zh_TW
lxlauncher	af ar cs da de es et eu fa fi fr gl hr hu id it ja ko lt ml nb nl nn pl ps pt_BR pt ru sk sl sv tr uk ur ur_PK vi zh_CN zh_TW
lxpanel	af ar be bg bn_IN bn ca cs da de el en_GB es es_VE et eu fa fi fo fr frp gl he hr hu id it ja kk km ko lg lt ml ms nb nl nn pa pl ps pt_BR pt ro ru sk sl sr@latin sr sv te th tr tt_RU ug uk ur ur_PK vi zh_CN zh_TW
lxpolkit	af am ar be bg bn_IN bn ca cs da de el en_GB es es_VE et eu fa fi fo fr frp gl he hr hu id it ja km ko lg lt ml ms nb nl nn pl ps pt_BR pt ro ru si sk sl sr@latin sr sv te th tr tt_RU uk ur ur_PK vi zh_CN zh_TW
lxrandr	af ar ast be bg bn_IN bn ca cs da de el en_GB es es_VE et eu fa fi fo fr frp gl he hr hu id it ja ko lg lt ml ms nb nl nn pl ps pt_BR pt ro ru sk sl sr@latin sr sv te th tr tt_RU uk ur ur_PK vi zh_CN zh_TW
lxsession-edit	af ar ast be bg bn_IN bn ca cs da de el en_GB es es_VE et eu fa fi fo fr frp gl he hr hu id it ja ko lg lt ml ms nb nl nn pa pl ps pt_BR pt ro ru si sk sl sr@latin sr sv te th tr tt_RU uk ur ur_PK vi zh_CN zh_TW
lxsession	af am ar ast be bg bn_IN bn ca cs da de el en_GB es es_VE et eu fa fi fo fr frp gl he hr hu id it ja ko lg lt ml ms nb nl nn pa pl ps pt_BR pt ro ru si sk sl sr@latin sr sv te th tr tt_RU uk ur ur_PK vi zh_CN zh_TW
lxshortcut	af ar cs da de es et eu fa fi fr gl hr hu id it ja ko lt ml ms nb nl nn pl ps pt_BR pt ru sk sl sv tr uk ur ur_PK vi zh_CN zh_TW
lxtask	af ar bg bn_IN ca cs da de el es es_VE et eu fa fi fr frp gl he hr hu id it ja ko lt ml ms nb nl nn pl ps pt_BR pt ru sk sl sr sv tr uk ur ur_PK vi zh_CN zh_TW
lxterminal	af ar be bg bn_IN bn ca cs da de el en_GB es es_VE et eu fa fi fo fr frp gl he hr hu id it ja ko lg lt ml ms nb nl nn pl ps pt_BR pt ro ru sk sl sr@latin sr sv te th tr tt_RU uk ur ur_PK vi zh_CN zh_TW
lynx	ca cs da de en eo et fi fr hu id it ja nl pt_BR ru sl sv tr uk vi zh_CN zh_TW
lyx	ar ca cs da de el en es eu fi fr gl he hu ia id it ja nb nl nn pl pt ro ru sk sr sv tr uk zh_CN zh_TW
make	be da de es fi fr ga gl he hr id it ja ko lt nl pl pt_BR ru sv tr uk vi zh_CN
mana	da de en_GB es fr hr hu it nl pl pt_BR pt ru sv
manaplus	cs de es fi fr id it ja nl_BE pl pt_BR pt ru tr zh_CN
marlin	ar bg bs ca ca@valencia cs da de el en_AU en_CA en_GB eo es eu fa fi fo fr he hi hr hu id it ja lt lv ms nb ne nl nn oc pl pt_BR pt ro ru si sk sl sr sv te th tr uk vi zh_CN zh_TW
mate-desktop	af am an ar as ast az be@latin be bg bn_IN bn br bs ca ca@valencia cmn crh cs cy da de dz el en_AU en_CA en_GB en@shaw eo es et eu fa fi fr fur ga gl gu he hi hr hu hy ia id ig is it ja ka kk kn ko ku ky li lo lt lv mai mg mi mk ml mn mr ms nb nds ne nl nn nso oc or pa pl ps pt_BR pt ro ru rw sc si sk sl sq sr@latin sr sv ta te th tk tr ug uk ur uz@cyrillic uz vi wa xh yi yo zh_CN zh_HK zh_TW zu
mate-polkit	am ar be bn_IN ca cmn cs da de el en_AU en_GB es eu fi fr gl gu he hi hr hu id it ja kn ko ky lt lv ml mr ms nb nl or pa pl pt_BR pt ro ru sk sl sq sv ta te th tr uk ur zh_CN zh_HK zh_TW
mate-system-monitor	am ar as ast az be@latin be bg bn_IN bn bs ca ca@valencia cmn cs cy da de dz el en_AU en_CA en_GB en@shaw eo es es_MX et eu fa fi fr ga gl gu he hi hr hu id it ja ka kk kn ko ku ky li lt lv mai mg mk ml mn mr ms nah nb nds ne nl nn oc or pa pl ps pt_BR pt ro ru rw si sk sl sq sr@latin sr sv ta te th tr ug uk ur vi zh_CN zh_HK zh_TW
mate-terminal	am ar as ast az be@latin be bg bn_IN bn br bs ca ca@valencia cmn cs cy da de dz el en_AU en_CA en_GB en@shaw eo es et eu fa fi fr fur ga gl gu he hi hr hu hy id it ja ka kk kn ko ku ky lt lv mai mg mk ml mn mr ms nb nds ne nl nn oc or pa pl ps pt_BR pt ro ru rw si sk sl sq sr@latin sr sv ta te th tr ug uk ur vi wa xh zh_CN zh_HK zh_TW
mc	az be bg ca cs da de_CH de el en_GB eo es et eu fa fi_FI fi fr gl hr hu ia id it ja ka kk ko lt lv mn nb nl pl pt_BR pt ro ru sk sl sr sv sv_SE szl ta tr uk vi wa zh_CN zh_TW
mcrypt	cs de el es_AR pl
meld	ar bg ca ca@valencia cs da de dz el en_CA en_GB eo es fi fr gl hu it ja ko nb ne nl oc pa pl pt_BR pt ro ru rw sl sq sr@latin sr sv vi zh_CN zh_TW
mercurial	da de el fr it ja pt_BR ro ru sv zh_CN zh_TW	hg	$PY/$P/locale/%/$LC
metacity	am ar as ast az be@latin be bg bn_IN bn br bs ca ca@valencia crh cs cy da de dz el en_CA en_GB en@shaw eo es et eu fa fi fr ga gl gu ha he hi hr hu hy id ig is it ja ka kn ko ku la lt lv mai mg mk ml mn mr ms nb nds ne nl nn oc or pa pl pt_BR pt ro ru rw si sk sl sq sr@latin sr sv ta te th tk tr uk vi wa xh yo zh_CN zh_HK zh_TW
mhwaveedit	de es fr it pl ru sv zh_CN
midori	ar ast be bg ca cs da de el en_GB eo es et eu fi fr gl he hr hu id it ja kk ko lt nl no pa pl pt_BR pt ro ru sk sr@latin sr sv tr ug uk zh_CN zh_TW
mingw32-binutils	da es fi fr ja ro rw sv tr vi zh_CN	bfd
mingw32-binutils	da es fi fr ja ro ru rw sk sv tr uk vi zh_CN zh_TW	binutils
mingw32-binutils	da de es fi fr ga id ms nl pt_BR ro rw sv tr vi	gprof
mingw32-binutils	da es fi fr ga sv tr vi zh_CN zh_TW	ld
mingw32-binutils	da de es fi fr ga id nl pt_BR ro sv tr vi zh_CN	opcodes
mingw32-binutils	es fr rw tr	gas
mingw32-gcc-c	be ca da de el es fr ja nl rw sv tr	gcc
mingw32-gcc	be ca da de el es fr ja nl rw sv tr	gcc
minicom	cs da de es fi fr hu id ja nb pl pt_BR ro ru rw sv vi zh_TW
mirage	cs de es fr hu it nl pl pt_BR ru ua zh_CN
miro	af ar be bg bn br bs ca ckb csb cs cy da de dv el en_AU en_CA en_GB eo es et eu fa fi fil fo fr fy ga gl gu he hi hr hu hy ia id is it ja jv ka kk km kn ko ku kw lb ltg lt lv mk ml mr ms mt nb nds ne nl nn oc pa pl pt_BR pt ro ru si sk sl sq sr sv swch ta ta_LK te th tl tr uk ur vi zh_CN zh_HK zh_TW zu
mono	de es ja pt_BR	mcs
moserial	ca cs da de es fr gl ko nb pt_BR sl sv zh_CN
mousepad	am ar be ca cs cy da de dz el en_GB eo es et eu fi fr gl gu he hu id it ja ka ko ku lt lv mk nb nl pa pl pt_BR pt_PT ru si sk sl sq sv ta tr uk ur zh_CN zh_TW
mp	de es it nl ru sv	minimum-profit
mplayerplug-in	cs da de en_US es fr hu it ja ko nb nl pl pt_BR ru se sk tr wa zh_CN
msmtp	de
ms-sys	sv
mtpaint	cs de es fr gl hu it ja nl pl pt_BR pt ru sk sv tl tr zh_CN zh_TW
mutt	bg ca cs da de el eo es et eu fr ga gl hu id it ja ko lt nl pl pt_BR ru sk sv tr uk zh_CN zh_TW
mypaint	cs de en_CA es fr hu id it ja ko nb nn_NO pl pt_BR ru sl sv uk zh_CN zh_TW
nabi	de ko
nagios-plugins	de fr
nano	bg ca cs da de es eu fi fr ga gl hu id it ms nb nl nn pl pt_BR ro ru rw sr sv tr uk vi zh_CN zh_TW
nanoshot	de es fr hr it ro ru tr uk zh_CN	Nanoshot
nanoshot	de es fr it ro ru tr uk zh_CN	Flickr	$US/Nanoshot/hostings/locale/%/$LC
nanoshot	de es fr it ro ru tr uk	ImageShack	$US/Nanoshot/hostings/locale/%/$LC
nanoshot	de es fr hr it ro ru tr uk	Imgur	$US/Nanoshot/hostings/locale/%/$LC
navit	af ar ast bg ca cs da de_CH de el en_AU en_GB eo es et eu fi fo fr_CH fr gl he hr hu id it ja jv kk lt lv mk nb nds nl nn pl pt_BR pt ro ru sk sl sr sv ta te th tr uk ur vi zh_CN zh_HK
ncmpc	cs da de eo es fi fr gl he hu it ko nb nl pl pt_BR ru sk sv uk zh_CN
ndisc6	cs en fr
neon	cs de fr ja nn pl ru tr zh_CN
net6	ast de en_GB es fr he it ko nb nl pt_BR pt ru sk sv uk zh_CN
network-manager	ar as be@latin bg bn_IN bs ca cs da de dz el en_CA en_GB eo es et eu fi fr gl gu he hi hr hu id it ja ka kn ko ku lt lv mk ml mr nb ne nl oc or pa pl pt_BR pt ru rw sk sl sq sr@latin sr sv ta te th tr uk vi wa zh_CN zh_HK zh_TW	NetworkManager
newt	ar as ast bal bg bn_IN bn bs ca cs cy da de dz el eo es et eu fi fr ga gl gu he hi hr hu id it ja km kn ko ku lt mg mk ml mr ms nb ne nl nn pa pl pt_BR pt ro ru sk sl sq sr@latin sr sv ta te th tl tr uk vi wo xh zh_CN zh_TW
nicotine+	da de es eu fi fr hu it lt nl pl pt_BR sk sv	nicotine
normalize	en_GB fr
notecase	ar ca cs da de el en_GB es et fi fr_CA fr hr hu id it ja ko ms nl no pl pt_BR pt ro ru sk sl sr sv ta tr zh_CN zh_TW
notification-daemon	ar cs da de el es et fr gl hu it ja lt nb nl pa pl pt_BR ru sl sv zh_CN
obby	ca de es fr it nl oc sv
obconf	ar be cs da de el en@boldquot en@quot es et fi fr he hr hu it ja lt lv nl no pl pt_BR ro ru sr@latin sr sv tr zh_CN zh_TW
ogmrip	cs de fr nb ru sk
openbox-imlib2	af ar be bn_IN ca cs da de en@boldquot en@quot es et eu fi fr he hr hu ia it ja lt lv nl no pl pt_BR pt ro ru sk sr@latin sr sv tr uk vi zh_CN zh_TW	openbox
openbox	af ar be bn_IN ca cs da de en@boldquot en@quot es et eu fi fr he hr hu ia it ja lt lv nl no pl pt_BR pt ro ru sk sr@latin sr sv tr uk vi zh_CN zh_TW
opencc	zh_CN zh_HK zh_TW
open-cobol	ja
openconnect	ar as ast bg_BG bg bn_IN bn bs ca ca@valencia cs da de el en_GB en_US eo es_CR es es_MX et eu fa fi fr gd gl gu he hi_IN hi hu id it ja km kn ko ku lo lt lv ml mr ms ms_MY nb nl nn no or pa pl pt_BR pt pt_PT ro ru sk sl sq sr@latin sr sv ta te tg tg_TJ th tl tl_PH tr ug uk ur_PK vi vi_VN wa zh_CN zh_HK zh_TW
openerp-client	al ar bg bs ca cs da de el es et eu fi fr hu id it lt ml nb nl pl pt_BR pt ro ru sl sr sv tr ua uk zh_CN zh
openerp-web	de_DE es_ES fr_FR it_IT	messages	$PY/locales/%/$LC
openshot	ady ar ast bg bn bs ca ca@valencia cs cy da de el en_AU en_CA en_GB eo es et eu fa fi fil fo fr fy gaa gl he hi hr hu hy id is it ja jv ka kn ko ky la lt lv ms nb ne nl nn oc pa pl pt_BR pt ro ru shn si sk sl sr sv ta te th tr ug uk uz vi zh_CN zh_HK zh_TW	OpenShot	$PY/$P/locale/%/$LC
opensp	de fr ja sv tr	sp5
orage	am ar ast az be bg bn_IN ca cs da de dz el en_AU en_GB eo es et eu fa fi fr gl gu he hi hu hy id it ja ka ko ku lt lv mk mr ms nb nl pa pl pt_BR pt ro ru sk sq sv ta tr uk ur ur_PK vi zh_CN zh_TW
orpheus	ca ru
osmo	bg ca cs da de el en_GB es fi fr hu it ja lt nl pl pt ru sv tr uk zh_CN
oxine	de es fr it ru uk
pam	ar as bn_IN ca cs da de es fi fr gu he hi hu it ja kk km kn ko ml mr ms nb nl or pa pl pt_BR pt ru si sk sr@latin sr sv ta te tr uk vi zh_CN zh_TW zu	Linux-PAM
pan	am ar az bg ca cs da de dz el en_CA en_GB es et eu fi fr ga gl hr hu it ja ko lt lv ms nb nl oc pl pt_BR pt ro ru sk sl sq sr@Latn sr sv tr uk vi zh_CN zh_TW
parcellite	cs da de es fr hu it ja nb pl pl_PL pt_BR ro ru sv tr zh_CN
parole	ar ast bg ca cs da de el en_GB es eu fr gl he hr hu id is it ja kk ko lt lv nl nn pl pt_BR pt ru sk sr sv te tr ug uk zh_CN zh_TW
partclone	fr_FR zh_TW
parted	ca cs da de es fr gl id it ja nl nn pl pt_BR pt ro ru rw sk sl sr sv tr uk vi zh_CN zh_TW
partimage	da de es eu fi fr gl it nl pl pt ru sk
partimage-pam	da de es eu fi fr gl it nl pl pt ru sk	partimage
pcmanfm	ar be bg bn ca cs da de el en_GB es et eu fa fi fo fr gl he hr hu id is it ja kk km ko lg lt lv ms nl pa pl pt_BR pt ro ru si sk sl sr@latin sr sv te th tr tt_RU ug uk vi zh_CN zh_TW
pcmanfm-legacy	af ar bg bn_IN ca cs da de el es et eu fa fi fr gl he hr hu id it ja km ko lt ml ms nb nl nn pl ps pt_BR pt ru sk sl sr sv tr uk ur ur_PK vi zh_CN zh_TW	pcmanfm
pcsxr-svn	fr_FR it pt_BR ru_RU zh_CN zh_TW	pcsx
pgadmin	ca_ES cs_CZ de_DE fr_FR ja_JP lv_LV pl_PL ru_RU sr_RS zh_CN	${P}3 wxstd	$US/${P}3/i18n/%
#pgadmin	/usr/share/pgadmin3/i18n/wxstd.mo
pidgin	af am ar ast az be@latin bg bn_IN bn bs ca ca@valencia cs da de dz el en_AU en_CA en_GB eo es et eu fa fi fr ga gl gu he hi hr hu hy id it ja ka km kn ko ku lo lt mai mhr mk mn mr ms_MY my_MM nb ne nl nn oc or pa pl ps pt_BR pt ro ru si sk sl sq sr@latin sr sv sw ta te th tr uk ur vi xh zh_CN zh_HK zh_TW
pidgin-libnotify	bg de es fr gl hu it nl pl pt_BR pt ro ru sl sv zh_CN
pidgin-musictracker	cs da de el en_AU en@boldquot en_GB en@quot es fi fr he hu id it nb nds nl pl pt_BR pt ro ru sk sl sv tr zh_CN	musictracker
pidgin-otr	ar de el es fa fr hu it my_MM nl nn pl ru sk sv vi zh_CN
pmount	bs ca cs de el en_AU en_GB en es et eu fa fr he hr hu id it ko ml nb nds nl pa pl pt_BR pt ro ru sk sr sv te tl tr vi yi zh_CN
pnmixer	de fr ru
poedit	af_ZA am ar ast be@latin be bg bn br ca ca@valencia cs da de el eo es es_PR et eu fa_IR fi fr fur ga gl he hi hr hu id is it ja ka kk ko ku ky lt lv mk mn ms nb nl nn pa pl pt_BR pt_PT ro ru sk sl sq_AL sr sv ta th tr tt ug uk ur uz vi wa zh_CN zh_TW
polkit	da	$P-1
polkit-pam	da	polkit-1
popt	cs da de eo es fi fr ga gl hu id is it ja ko lv nb nl pl pt ro ru sk sl sv th tr uk vi wa zh_CN zh_TW
powertop	nl
pulseaudio	as bn_IN ca cs de_CH de el es fi fr gu he hi hu id it ja kn ml mr nl or pa pl pt_BR pt ru sr@latin sr sv ta te uk zh_CN zh_TW
pv	de fr pl pt
#pyneighborhood	da de en_GB eo es fo fr gl he ja nb pt_BR pt ru zh_CN zh_TW	pyNeighborhood	/share/locale/%/$LC
pyroom	ar bg br ca cy da de el en_GB eo es eu fi fr ga gu hr hu id it ja ku lt lv mk nb nl nn pl pt_BR pt ro ru sco sk sl sr sv tr zh_CN
pysdm	es
pysolfc	ru ru_RU	pysol
python-django	af ar az be bg bn br bs ca cs cy da de el en_GB en eo es_AR es es_MX es_VE et eu fa fi fr fy_NL ga gl he hi hr hu ia id is it ja ka kk km kn ko lb lt lv mk ml mn nb ne nl nn pa pl pt_BR pt ro ru sk sl sq sr_Latn sr sv sw ta te th tr tt udm uk ur vi zh_CN zh_TW	django	$PY/django/conf/locale/%/$LC
python-django	af ar az be bg bn br bs ca cs cy da de el en_GB en eo es_AR es es_MX et eu fa fi fr fy_NL ga gl he hi hr hu ia id is it ja ka kk km kn ko lt lv mk ml mn nb ne nl nn pa pl pt_BR pt ro ru sk sl sq sr_Latn sr sv sw ta te th tr tt udm uk ur vi zh_CN zh_TW	django	$PY/django/contrib/admindocs/locale/%/$LC
python-django	af ar az be bg bn br bs ca cs cy da de el en_GB en eo es_AR es es_MX et eu fa fi fr fy_NL ga gl he hi hr hu ia id is it ja ka kk km kn ko lb lt lv mk ml mn nb ne nl nn pa pl pt_BR pt ro ru sk sl sq sr_Latn sr sv sw ta te th tr tt udm uk ur vi zh_CN zh_TW	djangojs	$PY/django/contrib/admin/locale/%/$LC
python-django	af ar az be bg bn br bs ca cs cy da de el en_GB en eo es_AR es es_MX et eu fa fi fr fy_NL ga gl he hi hr hu ia id is it ja ka kk km kn ko lb lt lv mk ml mn nb ne nl nn pa pl pt_BR pt ro ru sk sl sq sr_Latn sr sv sw ta te th tr tt udm uk ur vi zh_CN zh_TW	django	$PY/django/contrib/admin/locale/%/$LC
python-django	af ar az be bg bn br bs ca cs cy da de el en_GB en eo es_AR es es_MX et eu fa fi fr fy_NL ga gl he hi hr hu ia id is it ja ka kk km kn ko lt lv mk ml mn nb ne nl nn pa pl pt_BR pt ro ru sk sl sq sr_Latn sr sv sw ta te th tr tt uk ur vi zh_CN zh_TW	django	$PY/django/contrib/auth/locale/%/$LC
python-django	ar az be bg bn br bs ca cs cy da de el en_GB en eo es_AR es es_MX et eu fa fi fr fy_NL ga gl he hi hr hu ia id is it ja ka kk km kn ko lt lv mk ml mn nb ne nl nn pa pl pt_BR pt ro ru sk sl sq sr_Latn sr sv sw ta te th tr tt uk ur vi zh_CN zh_TW	django	$PY/django/contrib/comments/locale/%/$LC
python-django	ar az be bg bn br bs ca cs cy da de el en_GB en eo es_AR es es_MX et eu fa fi fr fy_NL ga gl he hi hr hu ia id is it ja ka kk km kn ko lt lv mk ml mn nb ne nl nn pa pl pt_BR pt ro ru sk sl sq sr_Latn sr sv sw ta te th tr tt uk ur vi zh_CN zh_TW	django	$PY/django/contrib/contenttypes/locale/%/$LC
python-django	af ar az be bg bn br bs ca cs cy da de el en_GB en eo es_AR es es_MX es_VE et eu fa fi fr fy_NL ga gl he hi hr hu ia id is it ja ka kk km kn ko lt lv mk ml mn nb ne nl nn pa pl pt_BR pt ro ru sk sl sq sr_Latn sr sv sw ta te th tr tt udm uk ur vi zh_CN zh_TW	django	$PY/django/contrib/flatpages/locale/%/$LC
python-django	ar az be bg bn br bs ca cs cy da de el en_GB en eo es_AR es es_MX et eu fa fi fr fy_NL ga gl he hi hr hu ia id is it ja ka kk km kn ko lt lv mk ml mn nb ne nl nn pa pl pt_BR pt ro ru sk sl sq sr_Latn sr sv sw ta te th tr tt uk ur vi zh_CN zh_TW	django	$PY/django/contrib/formtools/locale/%/$LC
python-django	ar az be bg bn br bs ca cs cy da de el en_GB en eo es_AR es es_MX et eu fa fi fr fy_NL ga gl he hi hr hu ia id is it ja ka kk km kn ko lt lv mk ml mn nb ne nl nn pa pl pt_BR pt ro ru sk sl sq sr_Latn sr sv sw ta te th tr tt uk ur vi zh_CN zh_TW	django	$PY/django/contrib/gis/locale/%/$LC
python-django	ar az be bg bn br bs ca cs cy da de el en_GB en eo es_AR es es_MX et eu fa fi fr fy_NL ga gl he hi hr hu ia id is it ja ka kk km kn ko lt lv mk ml mn nb ne nl nn pa pl pt_BR pt ro ru sk sl sq sr_Latn sr sv sw ta te th tr tt uk ur vi zh_CN zh_TW	django	$PY/django/contrib/humanize/locale/%/$LC
python-django	ar az be bg bn br bs ca cs da de el en_GB en eo es_AR es es_MX et eu fa fi fr fy_NL ga gl he hi hr hu ia id is it ja ka ko lt lv mk mn nb nl nn pa pl pt_BR pt ro ru sk sl sr_Latn sr sv sw te th tr uk vi zh_CN zh_TW	django	$PY/django/contrib/localflavor/locale/%/$LC
python-django	ar az be bg bn br bs ca cs cy da de el en_GB en eo es_AR es es_MX et eu fa fi fr fy_NL ga gl he hi hr hu ia id is it ja ka kk km kn ko lt lv mk ml mn nb ne nl nn pa pl pt_BR pt ro ru sk sl sq sr_Latn sr sv sw ta te th tr tt uk ur vi zh_CN zh_TW	django	$PY/django/contrib/messages/locale/%/$LC
python-django	ar az be bg bn br bs ca cs cy da de el en_GB en eo es_AR es es_MX et eu fa fi fr fy_NL ga gl he hi hr hu id is it ja ka kk km kn ko lt lv mk ml mn nb ne nl nn pa pl pt_BR pt ro ru sk sl sq sr_Latn sr sv sw ta te th tr tt uk ur vi zh_CN zh_TW	django	$PY/django/contrib/redirects/locale/%/$LC
python-django	ar az be bg bn br bs ca cs cy da de el en_GB en eo es_AR es es_MX et eu fa fi fr fy_NL ga gl he hi hr hu id is it ja ka kk km kn ko lt lv mk ml mn nb ne nl nn pa pl pt_BR pt ro ru sk sl sq sr_Latn sr sv sw ta te th tr tt uk ur vi zh_CN zh_TW	django	$PY/django/contrib/sessions/locale/%/$LC
python-django	ar az be bg bn br bs ca cs cy da de el en_GB en eo es_AR es es_MX et eu fa fi fr fy_NL ga gl he hi hr hu id is it ja ka kk km kn ko lt lv mk ml mn nb ne nl nn pa pl pt_BR pt ro ru sk sl sq sr_Latn sr sv sw ta te th tr tt uk ur vi zh_CN zh_TW	django	$PY/django/contrib/sites/locale/%/$LC
python-formalchemy	de en es fr hu pl pt_BR	formalchemy	$PY/formalchemy/i18n_resources/%/$LC
python-formencode	cs de el es et fi fr it ja lt nb_NO nl pl pt_BR pt_PT ru sk sl tr zh_CN zh_TW	FormEncode	$PY/formencode/i18n/%/$LC
python-gazpacho	ca es fi fr gl it pt_BR pt ru sv zh_CN	gazpacho
python-kiwi	es_CL es_ES fr it pl pt_BR sv	kiwi
python-pyxml	de en_US fr	4Suite	$PY/_xmlplus/dom/%/$LC
python-sphinx	cs de es fi fr it ja nl pl pt_BR ru sl uk_UA zh_TW	sphinx	$PY/sphinx/locale/%/$LC
python-turbogears	de sl	TurboGears	$PY/TurboGears-1.1-py2.7.egg/turbogears/i18n/data/%/$LC
python-turbogears	en fi	messages	$PY/TurboGears-1.1-py2.7.egg/turbogears/tests/locale/%/$LC
qarte	de fr pt		$US/$P/locale/%/$LC
quarry	en_GB en fr pl ru
quodlibet	bg de en_CA en_GB es fi fr gl_ES gl he hu it ja ko lt nb nl pl pt ro ru sk sv uk zh_CN zh_TW
quota	cs de fr pl
radiotray	de en_GB es fr gu hu it lt pl pt_BR pt ro ru sk sl sv te tr uk zh_CN
rapidsvn	de es fr it_IT ja pt_BR ru uk zh_CN
rawstudio	ca cs da de en es fi fr it nb nl pl pt_BR ru sv
rdpdesk	ru
redshift	ar ca cs da de es eu fi fr gl he it ka lt nl pl pt_BR ru zh_CN
remmina	bg ca cs da de el es eu fr hu id it kk lt nl pl pt_BR pt_PT ru sk sv th tr uk zh_CN
remmina	bg cs da de el es eu fr hu id it kk lt nl pl pt_BR pt_PT ru sk sv th tr uk zh_CN	$P-plugins
remmina-plugins	bg cs da de el es eu fr hu id it kk lt nl pl pt_BR pt_PT ru sk sv th tr uk zh_CN
retawq	de es fr ja pt_BR
R	de en@quot fr ko pl ru	R-boot	$R/boot/po/%/$LC
R	de en@quot fr ko pl	R-class	$R/class/po/%/$LC
R	de en@quot fr pl	R-cluster	$R/cluster/po/%/$LC
R	en@quot	cluster	$R/cluster/po/%/$LC
R	de en@quot fr pl	foreign	$R/foreign/po/%/$LC
R	de en@quot fr pl	R-foreign	$R/foreign/po/%/$LC
R	de en@quot fr ko pl	R-KernSmooth	$R/KernSmooth/po/%/$LC
R	de en@quot fr ko pl	R-lattice	$R/lattice/po/%/$LC
R	de en@quot fr ko pl	R-MASS	$R/MASS/po/%/$LC
R	de en@quot pl	Matrix	$R/Matrix/po/%/$LC
R	de en@quot fr pl	R-Matrix	$R/Matrix/po/%/$LC
R	de en@quot fr ko pl	nlme	$R/nlme/po/%/$LC
R	de en@quot fr ko pl	R-nlme	$R/nlme/po/%/$LC
R	de en@quot fr ko pl	R-nnet	$R/nnet/po/%/$LC
R	de en@quot fr ko pl ru	rpart	$R/rpart/po/%/$LC
R	de en@quot fr ko pl ru	R-rpart	$R/rpart/po/%/$LC
R	de en@quot fr pl	R-spatial	$R/spatial/po/%/$LC
R	da de en@quot es fr it ja ko nn pl pt_BR ru tr zh_CN zh_TW	graphics	$RT
R	da de en_GB en@quot fr it ja ko pl pt_BR ru zh_CN	grDevices	$RT
R	da de en@quot fr it ja ko pl pt_BR ru zh_CN	grid	$RT
R	da de en@quot fr ja ko pl pt_BR ru zh_CN	methods	$RT
R	da de en@quot fr ko pl ru zh_CN	parallel	$RT
R	da de en@quot fa fr it ja ko nn pl pt_BR ru tr zh_CN	R-base	$RT
R	da de en@quot fr ja ko pl pt_BR ru zh_CN	R-compiler	$RT
R	da de en@quot fr it ja ko pl pt_BR ru zh_CN	R-graphics	$RT
R	da de en_GB en@quot fr it ja ko pl pt_BR ru zh_CN	R-grDevices	$RT
R	da de en@quot fr ja ko pl pt_BR ru zh_CN	R-grid	$RT
R	da de es fa fr it ja ko nn pl pt_BR ru tr zh_CN zh_TW	RGui	$RT
R	da de en@quot fr ja ko pl pt_BR ru zh_CN	R-methods	$RT
R	da de en_GB en en@quot es fa fr it ja ko nn pl pt_BR ru tr zh_CN zh_TW		$RT
R	da de en@quot fr ko pl ru zh_CN	R-parallel	$RT
R	da de en@quot fr ja ko pl pt_BR ru zh_CN	R-splines	$RT
R	da de en@quot fr it ja ko pl pt_BR ru tr zh_CN	R-stats4	$RT
R	da de en@quot fr it ja ko pl pt_BR ru tr zh_CN	R-stats	$RT
R	da de en@quot fr it ja ko pl pt_BR ru zh_CN	R-tcltk	$RT
R	da de en@quot fr it ja ko pl pt_BR ru tr zh_CN	R-tools	$RT
R	da de en@quot fa fr ja ko pl pt_BR ru tr zh_CN	R-utils	$RT
R	da de en@quot fr ja ko pl pt_BR ru zh_CN	splines	$RT
R	da de en@quot fr it ja ko pl pt_BR ru zh_CN	stats	$RT
R	da de en@quot fr ja ko pl pt_BR ru zh_CN	tcltk	$RT
R	da de en@quot fr it ja ko pl pt_BR ru zh_CN	tools	$RT
R	de en@quot ko pl	utils	$RT
roundup	de en es fr hu it ja lt ru zh_CN zh_TW
#rox-filer	de es fr it	ROX-Filer	/Messages/%/$LC
#rox-filer-locales	cs da de es et_EE eu fi fr hu it ja nl no pl pt_BR pt_PT ro ru sv uk vi zh_CN zh_TW	ROX-Filer	/Messages/%/$LC
rpm4	bn_IN ca cs_CZ cs da de el eo es fi fr gu id is it ja ko ms nb nl pl pt_BR pt ru sk sl sr@latin sr sv te tr zh_CN zh_TW	rpm
sakura	ca cs de es fr hr hu it ja ko pl pt_BR ru zh_CN
samba	ar cs da de es fi fr hu it ja ko nb nl pl pt_BR ru sv zh_CN zh_TW	pam_winbind
samba	de	net
samba-pam	ar cs da de es fi fr hu it ja ko nb nl pl pt_BR ru sv zh_CN zh_TW	pam_winbind
samba-pam	de	net
sane-backends	bg cs da de en_GB eo es fi fr gl it ja nb nl pl pt ru sv uk
sarg	bg ca cs de el es fr hu id it ja lv nl pl pt ro ru sk sr tr uk zh_CN
sbackup	ar bg ca cs da de el en_AU en_CA en_GB es fa fi fo fr gl he hu id is it ja kk ko kw lv ms nb nl oc pl pt_BR pt ro ru sr sv sw tr uk zh_CN zh_TW
scim	as bn_IN ca cs de es fi fr gu hi it ja kn ko ml mr nl pa pt_BR ru sk sv ta te vi zh_CN zh_TW
scim-pinyin	de fr it ja ko zh_CN zh_TW
scim-tables	de fr it ja ko nl pa zh_CN zh_TW
screenlets	ar bg bn bs ca cs da de el en_AU en_CA es et fi fo fr hr ht hu id it ja jv ko lt nb nds nl pl pt_BR pt ro ru si sk sl sq sr sv te th tr uk zh_CN zh_TW	$P-manager
screenlets	ar bg bn bs ca cs da de el en_AU es et fa fi fr he hr hu id it ja jv ko lt lv nb nl pl pt_BR pt ro ru si sk sl sq sr sv tr uk vi zh_CN zh_HK zh_TW
searchmonkey	en_GB en_UK en_US
sed	af ca cs da de el eo es et eu fi fr ga gl he hr hu id it ja ko nl pl pt_BR pt ro ru sk sl sr sv tr uk vi zh_CN zh_TW
shared-mime-info	ar az be@latin bg_BG bg bn_IN ca ca@valencia cs cy da de el en_GB eo es eu fa_IR fa fi fo fr ga gl he hi hr hu ia id it ja ka kk ko lt lv ms nb nl nn pa pl pt_BR pt ro ru rw sk sl sq sr@latin sr sv te tr uk vi wa zh_CN zh_HK zh_TW
slitaz-base-files	el es fr pl pt_BR ru sv	slitaz-base
slitaz-tools-boxes	el es fa fr pl pt_BR ru sv zh_CN zh_TW	tazbox
slitaz-tools-boxes	es fa fr pl pt_BR ru sv	slitaz-boxes
slitaz-tools	el es fa fr pl pt_BR ru sv
snownews	be@latin de es fr it ja nl pl pt_BR ru se sl uk_UA zh_CN zh_TW
sonata	ar be@latin ca cs da de el_GR es et fi fr it ja nl pl pt_BR ru sk sl sv tr uk zh_CN zh_TW
songwrite	en fr	${P}2
spacefm	af ar bg bn_IN ca cs da de el es et eu fa fi fr gl he hr hu id it ja km ko lt ml ms nb nl nn pl ps pt_BR pt ru sk sl sr@latin sr sv tr uk ur ur_PK vi zh_CN zh_TW
#squirrelmail-autorespond	it_IT ja_JP	autorespond	/autorespond/locale/%/$LC
#squirrelmail-html	ca_ES cs_CZ da_DK de_DE es_ES fr_FR he_IL id_ID it_IT ja_JP lt_LT nb_NO nl_NL no_NO pl_PL pt_PT sv_SE tr_TR	view_as_html	/view_as_html/locale/%/$LC
#squirrelmail-sieve	bg_BG cs_CZ de_DE el_GR es_ES fi_FI fr_FR is_IS it_IT lt_LT nb_NO nl_NL pl_PL pt_BR ro_RO ru_RU zh_CN	avelsieve	/avelsieve/locale/%/$LC
#squirrelmail-vkeyboard	cs_CZ de_DE el es_ES fr_FR fr hu_HU it nl_NL pl_PL pt_BR ru_RU	vkeyboard	/vkeyboard/locale/%/$LC
ssfs	fr ru
stardict	ar cs de el fr ga hr hu ku mk nl pt_BR ru rw sk sv tr tt uk vi zh_CN zh_TW
steadyflow	ar ast be bg bn bs ca cs da de el en_AU en_CA en_GB eo es et eu fa fi fo fr gl gu he hi hr hu id it ja ka ko lt ml ms my nb nl nn pl pt_BR pt ro ru si sk sl sr sv te tr uk vi zh_CN zh_TW
stellarium	af ar az be bg bn bo br bs ca cs cy da de dv el en_AU en_CA en_GB en eo es et eu fa fi fil fr fy ga gl gu gv haw he hi hr hrx hu hy ia id is it ja ka kn ko lt lv mk ml mr ms mt nan nb nl nn oc pl pt_BR pt ro ru sco se si sk sl sq sr sv ta te th tl tr uk vi zh_CN zh_HK zh_TW
stellarium	af ar az be bg bn bs ca cs cy da de dv el en_AU en_CA en_GB en eo es et eu fa fi fil fr ga gl gu haw he hi hr hu hy ia id is it ja ka kn ko lt lv mk ml mr ms mt nan nb nl nn pl pt_BR pt ro ru se si sk sl sq sr sv te th tl tr uk vi zh_CN zh_HK zh_TW	$P-skycultures
stoqdrivers	es_ES pt_BR
stoq	es_CL es_ES pt_BR sv
stoqlib	es_ES pt_BR sv
sudo	ca cs da de eo es eu fi fr gl hr it ja nl pl pt_BR ru sl sr sv tr uk vi zh_CN
sudo	cs da de eo eu fi hr it ja lt nl pl pt_BR sl sr sv tr uk vi zh_CN	sudoers
sudoku-savant	de fr
sudo-pam	ca cs da de eo es eu fi fr gl hr it ja nl pl pt_BR ru sl sr sv tr uk vi zh_CN	sudo
sudo-pam	cs da de eo eu fi hr it ja lt nl pl pt_BR sl sr sv tr uk vi zh_CN	sudoers
sylpheed-full	be bg cs da de el es et fi fr gl hr hu it ja ko lt nl pl pt_BR ro ru sk sl sr sv tr uk vi zh_CN zh_TW	sylpheed
sylpheed	be bg cs da de el es et fi fr gl hr hu it ja ko lt nl pl pt_BR ro ru sk sl sr sv tr uk vi zh_CN zh_TW
sysstat	af cs da de eo es eu fi fr hr id it ja ky lv mt nb nl nn pl pt_BR pt ro ru sk sr sv uk vi zh_CN zh_TW
system-tools-backends	ar bg bn_IN ca cs da de el en_GB es et eu fi fr gl gu he hi hu it ja kn nb nds or pa pl pt_BR pt ro sl sr@latin sr sv ta te th tr uk zh_CN zh_HK zh_TW
tar	bg ca cs da de el es et eu fi fr ga gl hr hu id it ja ko ky ms nb nl pl pt_BR pt ro ru sk sl sv tr uk vi zh_CN zh_TW
tazdrop	fr pl pt_BR ru
tazinst	el es fr pt_BR ru sv	installer
tazinst	es_AR fr pt_BR ru
tazinst	pt_BR ru	slitaz-installer
tazirc	fr pt_BR
tazlito	el es fr pl pt_BR ru zh_CN zh_TW	$P-wiz
tazpanel	el es fr pl pt_BR ru sv
tazpkg	el es fr pl pt_BR ru sv
tazusb	el fr pl pt_BR	$P $P-box
tazweb	fr pt_BR ru
terminal	ar ast be bg ca cs da de el en_AU en_GB eo es et eu fi fr gl he hr hu id is it ja kk ko lt lv nb nl oc pa pl pt_BR pt ro ru si sk sq sr sv te th tr ug uk ur ur_PK vi zh_CN zh_TW	xfce4-${P}
terminator	af ar ast bg bn ca ca@valencia cs da de el en_AU en_CA en_GB eo es et eu fa fi fr fy ga gl he hi hr hu id it ja jv ka kk ko lt lv mk ml mr ms nb nl nn oc pl pt_BR pt ro ru ru_RU si sk sl sq sr sv ta te th tr tyv uk ur zh_CN zh_HK zh_TW
texinfo	cs da de_AT de eo es fr he hr hu ja nb nl pl ro ru rw sv tr vi zh_CN zh_TW
thunar-archive-plugin	ar ast be ca cs da de el en_GB eo es eu fi fr gl hr hu id it ja kk lv nb nl pa pl pt_BR pt ro ru sk sq sv tr ug uk ur ur_PK zh_CN zh_TW
thunar	ar ast be bn ca cs da de dz el en_GB eo es et eu fi fr gl he hr hu id is it ja ka kk ko ku lt lv mk nb nl nn pa pl pt_BR pt ro ru si sk sq sr sv te tr ug uk ur ur_PK vi zh_CN zh_TW	Thunar
thunar-vfs	ar be bn ca cs da de dz el en_GB eo es et eu fi fr gl he hr hu id it ja ka kk ko ku lt lv mk nb nl nn pa pl pt_BR pt ro ru sk sq sv tr ug uk ur ur_PK vi zh_CN zh_TW
thunar-volman	ar ast be bg ca cs da de el en_GB es eu fi fr gl hr hu id is it ja kk ko lt lv nb nl nn pl pt_BR pt ro ru sk sq sv te tr ug uk ur ur_PK zh_CN zh_TW
tilda	ca cs de el en_GB es fr hu it pl pt_BR pt ru sk sl sv tr zh_CN
tinycm	fr pt_BR
transmission	an ar ast az be@latin be bg bn bo br bs ca ca@valencia ceb ckb cs da de el en_AU en_CA en_GB eo es et eu fa fi fil fo fr ga gl gv he hi hr hu hy ia id is it ja ka kk ko ku ky li lt lv mk ml mr ms mt my nb nds nl nn oc pa pl pt_BR pt ro ru si sk sl sq sr sv sw ta_LK te th tl tr ug uk ur uz vi zh_CN zh_TW	$P-gtk
transmission-remote-gtk	de es ko pl ru uk
tsclient	ar ca cs da de el es fi fr gr he hu id it ja mk ms nb nl_NL pa pl_PL pt_BR pt_PT ru sv tr xh zh_CN zh_HK zh_TW
tumbler	ar ast bg bn ca cs da de el en_GB es eu fi fr gl he hu id is it ja kk ko lt lv nb nl nn pa pl pt_BR pt ro ru si sk sr sv te tr ug uk zh_CN zh_TW
tuxmath	ar ast bg cs da de el en@boldquot en_GB en@quot es fi fr ga he hi hu it ja ku mn nb nl nn oc pl pt_BR pt ro ru sk sl sv tl tr uk vi zam zh_CN zh_TW
tuxpaint	af ar ast az be bg bo br ca cs cy da de el en_AU en_CA en_GB en_ZA eo es es_MX et eu fi fo fr ga gd gl gos gu he hi hr hu id is it ja ka km ko ku lt lv mk ms nb nl nn nr oc oj pl pt_BR pt ro ru rw shs sk sl son sq sr sv sw ta te th tlh tl tr twi uk ve vi wa wo xh zam zh_CN zh_TW
tuxtype	ar as ast ca cs da de el en@boldquot en_GB en@quot es eu fi fr gu hi it ja kn lt ml nb ne nl nn or pt ru sv sw ta te tr wo zh_N
ucarp	en@boldquot en@quot
udevil	de es fr it pl pt_BR ru sv
udisks2	da
udisks	da
ufraw	ca cs da de es fr it ja ko nb nl pl pt ru sr@latin sr sv zh_CN zh_TW
uget	ar be bn_BD cs da de es fr hu id it ka_GE pl pt_BR ru tr uk vi zh_CN zh_TW
upower	fr it pl sv
usbmanager	de es fr pt_BR ru
util-linux	ca cs da de es et eu fi fr gl hr hu id it ja nl pl pt_BR ru sl sv tr uk vi zh_CN zh_TW
varka	bs ca cs de en_AU en_CA en_GB eo es eu fi fr hu it lv nl pl pt_BR sk sv tr
vice	da de fr hu it nl pl sv tr
viewnior	ar bg ca ca@valencia cs da de el es fi fr gl he hu it ja lt nl oc pl pt_BR pt ru sk sr sv tr uk zh_CN
vim	af ca cs de en_GB eo es fi fr ga it ja ko ko.UTF-8 nb no pl pt_BR ru sk sv uk vi zh_CN zh_CN.UTF-8 zh_TW zh_TW.UTF-8		$US/$P/vim73/lang/%/$LC
vim-tiny	af ca cs de en_GB eo es fi fr ga it ja ko ko.UTF-8 nb no pl pt_BR ru sk sv uk vi zh_CN zh_CN.UTF-8 zh_TW zh_TW.UTF-8	vim	$US/vim/vim73/lang/%/$LC
visualboyadvance	fr	vba-1.7.2	/usr/games/locale/%/$LC
vlc	ach af am an ar ast az be bg bn_IN bn br bs ca cgg ckb co cs cy da de el en_GB es et eu fa ff fi fr fur ga gd gl gu he hi hr hu hy ia id is it ja ka kk km kn ko ky lg lt lv mk ml mn mr ms my nb ne nl nn oc or pa pl ps pt_BR pt_PT ro ru si sk sl sq sr sv ta te tet th tl tr uk uz vi wa zh_CN zh_TW zu
vmware-view-open-client	de fr ja zh_CN	vmware-view
vorbis-tools	be cs da en_GB eo es fr hr hu nl pl ro ru sk sv uk vi
vte	am ang ar as ast az be@latin be bg bn_IN bn bs ca ca@valencia cs cy da de dz el en_CA en_GB en@shaw eo es et eu fa fi fr ga gl gu he hi hr hu id is it ja ka kn ko ku ky li lt lv mai mi mk ml mn mr ms nb nds ne nl nn oc or pa pl pt_BR pt ro ru rw si sk sl sq sr@latin sr sv ta te th tr ug uk vi wa xh zh_CN zh_HK zh_TW	$P-0.0
w3m	ja
wammu	af bg ca cs da de el es et fi fr gl he hu id it ko nl pl pt_BR ru sk sv sw zh_CN zh_TW
warmux	bg bs ca cpf cs da de el eo es et fa fi fr gl he hu it ja_JP kw lv nb nl nn pl pt_BR pt ro ru sk sl sv tr uk zh_CN zh_TW
warzone2100	ca_ES cs da de en_GB es et_EE fi fr fy ga hr hu it ko la lt nb nl pl pt_BR pt ro ru sk sl tr uk_UA zh_CN zh_TW
wbar2	de es fi	wbar
webkit-r	ar bg cs de el en_CA en_GB es et eu fr gl gu he hu id it ko lt lv nb nl pa pl pt_BR pt ru sl sr@latin sr sv uk vi zh_CN	webkit-2.0
weechat	cs de es fr hu it ja pl pt_BR ru
wesnoth	af ang@latin ang ar bg ca_ES@valencia ca cs da de el en_GB en@shaw eo es et eu fi fr fur_IT ga gl he hr hu id is it ja ko la lt lv mk mr nb_NO nl pl pt_BR pt racv ro ru sk sl sr@ijekavianlatin sr@ijekavian sr@latin sr sv tl tr uk vi zh_CN zh_TW	$P-anl	$US/$P/translations/%/$LC
wesnoth	af ang@latin ang ar bg ca_ES@valencia ca cs da de el en_GB en@shaw eo es et eu fi fr fur_IT ga gl he hr hu id is it ja ko la lt lv mk mr nb_NO nl pl pt_BR pt racv ro ru sk sl sr@ijekavianlatin sr@ijekavian sr@latin sr sv tl tr uk vi zh_CN zh_TW	$P-aoi	$US/$P/translations/%/$LC
wesnoth	af ang@latin ang ar bg ca_ES@valencia ca cs da de el en_GB en@shaw eo es et eu fi fr fur_IT ga gl he hr hu id is it ja ko la lt lv mk mr nb_NO nl pl pt_BR pt racv ro ru sk sl sr@ijekavianlatin sr@ijekavian sr@latin sr sv tl tr uk vi zh_CN zh_TW	$P-did	$US/$P/translations/%/$LC
wesnoth	af ang@latin ang ar bg ca_ES@valencia ca cs da de el en_GB en@shaw eo es et eu fi fr fur_IT ga gl he hr hu id is it ja ko la lt lv mk mr nb_NO nl pl pt_BR pt racv ro ru sk sl sr@ijekavianlatin sr@ijekavian sr@latin sr sv tl tr uk vi zh_CN zh_TW	$P-dm	$US/$P/translations/%/$LC
wesnoth	af ang@latin ang ar bg ca_ES@valencia ca cs da de el en_GB en@shaw eo es et eu fi fr fur_IT ga gl he hr hu id is it ja ko la lt lv mk mr nb_NO nl pl pt_BR pt racv ro ru sk sl sr@ijekavianlatin sr@ijekavian sr@latin sr sv tl tr uk vi zh_CN zh_TW	$P-dw	$US/$P/translations/%/$LC
wesnoth	af ang@latin ang ar bg ca_ES@valencia ca cs da de el en_GB en@shaw eo es et eu fi fr fur_IT ga gl he hr hu id is it ja ko la lt lv mk mr nb_NO nl pl pt_BR pt racv ro ru sk sl sr@ijekavianlatin sr@ijekavian sr@latin sr sv tl tr uk vi zh_CN zh_TW	$P-editor	$US/$P/translations/%/$LC
wesnoth	af ang@latin ang ar bg ca_ES@valencia ca cs da de el en_GB en@shaw eo es et eu fi fr fur_IT ga gl he hr hu id is it ja ko la lt lv mk mr nb_NO nl pl pt_BR pt racv ro ru sk sl sr@ijekavianlatin sr@ijekavian sr@latin sr sv tl tr uk vi zh_CN zh_TW	$P-ei	$US/$P/translations/%/$LC
wesnoth	af ang@latin ang ar bg ca_ES@valencia ca cs da de el en_GB en@shaw eo es et eu fi fr fur_IT ga gl he hr hu id is it ja ko la lt lv mk mr nb_NO nl pl pt_BR pt racv ro ru sk sl sr@ijekavianlatin sr@ijekavian sr@latin sr sv tl tr uk vi zh_CN zh_TW	$P-help	$US/$P/translations/%/$LC
wesnoth	af ang@latin ang ar bg ca_ES@valencia ca cs da de el en_GB en@shaw eo es et eu fi fr fur_IT ga gl he hr hu id is it ja ko la lt lv mk mr nb_NO nl pl pt_BR pt racv ro ru sk sl sr@ijekavianlatin sr@ijekavian sr@latin sr sv tl tr uk vi zh_CN zh_TW	$P-httt	$US/$P/translations/%/$LC
wesnoth	af ang@latin ang ar bg ca_ES@valencia ca cs da de el en_GB en@shaw eo es et eu fi fr fur_IT ga gl he hr hu id is it ja ko la lt lv mk mr nb_NO nl pl pt_BR pt racv ro ru sk sl sr@ijekavianlatin sr@ijekavian sr@latin sr sv tl tr uk vi zh_CN zh_TW	$P-lib	$US/$P/translations/%/$LC
wesnoth	af ang@latin ang ar bg ca_ES@valencia ca cs da de el en_GB en@shaw eo es et eu fi fr fur_IT ga gl he hr hu id is it ja ko la lt lv mk mr nb_NO nl pl pt_BR pt racv ro ru sk sl sr@ijekavianlatin sr@ijekavian sr@latin sr sv tl tr uk vi zh_CN zh_TW	$P-l	$US/$P/translations/%/$LC
wesnoth	af ang@latin ang ar bg ca_ES@valencia ca cs da de el en_GB en@shaw eo es et eu fi fr fur_IT ga gl he hr hu id is it ja ko la lt lv mk mr nb_NO nl pl pt_BR pt racv ro ru sk sl sr@ijekavianlatin sr@ijekavian sr@latin sr sv tl tr uk vi zh_CN zh_TW	$P-low	$US/$P/translations/%/$LC
wesnoth	af ang@latin ang ar bg ca_ES@valencia ca cs da de el en_GB en@shaw eo es et eu fi fr fur_IT ga gl he hr hu id is it ja ko la lt lv mk mr nb_NO nl pl pt_BR pt racv ro ru sk sl sr@ijekavianlatin sr@ijekavian sr@latin sr sv tl tr uk vi zh_CN zh_TW	$P-manpages	$US/$P/translations/%/$LC
wesnoth	af ang@latin ang ar bg ca_ES@valencia ca cs da de el en_GB en@shaw eo es et eu fi fr fur_IT ga gl he hr hu id is it ja ko la lt lv mk mr nb_NO nl pl pt_BR pt racv ro ru sk sl sr@ijekavianlatin sr@ijekavian sr@latin sr sv tl tr uk vi zh_CN zh_TW	$P-manual	$US/$P/translations/%/$LC
wesnoth	af ang@latin ang ar bg ca_ES@valencia ca cs da de el en_GB en@shaw eo es et eu fi fr fur_IT ga gl he hr hu id is it ja ko la lt lv mk mr nb_NO nl pl pt_BR pt racv ro ru sk sl sr@ijekavianlatin sr@ijekavian sr@latin sr sv tl tr uk vi zh_CN zh_TW		$US/$P/translations/%/$LC
wesnoth	af ang@latin ang ar bg ca_ES@valencia ca cs da de el en_GB en@shaw eo es et eu fi fr fur_IT ga gl he hr hu id is it ja ko la lt lv mk mr nb_NO nl pl pt_BR pt racv ro ru sk sl sr@ijekavianlatin sr@ijekavian sr@latin sr sv tl tr uk vi zh_CN zh_TW	$P-multiplayer	$US/$P/translations/%/$LC
wesnoth	af ang@latin ang ar bg ca_ES@valencia ca cs da de el en_GB en@shaw eo es et eu fi fr fur_IT ga gl he hr hu id is it ja ko la lt lv mk mr nb_NO nl pl pt_BR pt racv ro ru sk sl sr@ijekavianlatin sr@ijekavian sr@latin sr sv tl tr uk vi zh_CN zh_TW	$P-nr	$US/$P/translations/%/$LC
wesnoth	af ang@latin ang ar bg ca_ES@valencia ca cs da de el en_GB en@shaw eo es et eu fi fr fur_IT ga gl he hr hu id is it ja ko la lt lv mk mr nb_NO nl pl pt_BR pt racv ro ru sk sl sr@ijekavianlatin sr@ijekavian sr@latin sr sv tl tr uk vi zh_CN zh_TW	$P-sof	$US/$P/translations/%/$LC
wesnoth	af ang@latin ang ar bg ca_ES@valencia ca cs da de el en_GB en@shaw eo es et eu fi fr fur_IT ga gl he hr hu id is it ja ko la lt lv mk mr nb_NO nl pl pt_BR pt racv ro ru sk sl sr@ijekavianlatin sr@ijekavian sr@latin sr sv tl tr uk vi zh_CN zh_TW	$P-sotbe	$US/$P/translations/%/$LC
wesnoth	af ang@latin ang ar bg ca_ES@valencia ca cs da de el en_GB en@shaw eo es et eu fi fr fur_IT ga gl he hr hu id is it ja ko la lt lv mk mr nb_NO nl pl pt_BR pt racv ro ru sk sl sr@ijekavianlatin sr@ijekavian sr@latin sr sv tl tr uk vi zh_CN zh_TW	$P-tb	$US/$P/translations/%/$LC
wesnoth	af ang@latin ang ar bg ca_ES@valencia ca cs da de el en_GB en@shaw eo es et eu fi fr fur_IT ga gl he hr hu id is it ja ko la lt lv mk mr nb_NO nl pl pt_BR pt racv ro ru sk sl sr@ijekavianlatin sr@ijekavian sr@latin sr sv tl tr uk vi zh_CN zh_TW	$P-test	$US/$P/translations/%/$LC
wesnoth	af ang@latin ang ar bg ca_ES@valencia ca cs da de el en_GB en@shaw eo es et eu fi fr fur_IT ga gl he hr hu id is it ja ko la lt lv mk mr nb_NO nl pl pt_BR pt racv ro ru sk sl sr@ijekavianlatin sr@ijekavian sr@latin sr sv tl tr uk vi zh_CN zh_TW	$P-thot	$US/$P/translations/%/$LC
wesnoth	af ang@latin ang ar bg ca_ES@valencia ca cs da de el en_GB en@shaw eo es et eu fi fr fur_IT ga gl he hr hu id is it ja ko la lt lv mk mr nb_NO nl pl pt_BR pt racv ro ru sk sl sr@ijekavianlatin sr@ijekavian sr@latin sr sv tl tr uk vi zh_CN zh_TW	$P-trow	$US/$P/translations/%/$LC
wesnoth	af ang@latin ang ar bg ca_ES@valencia ca cs da de el en_GB en@shaw eo es et eu fi fr fur_IT ga gl he hr hu id is it ja ko la lt lv mk mr nb_NO nl pl pt_BR pt racv ro ru sk sl sr@ijekavianlatin sr@ijekavian sr@latin sr sv tl tr uk vi zh_CN zh_TW	$P-tsg	$US/$P/translations/%/$LC
wesnoth	af ang@latin ang ar bg ca_ES@valencia ca cs da de el en_GB en@shaw eo es et eu fi fr fur_IT ga gl he hr hu id is it ja ko la lt lv mk mr nb_NO nl pl pt_BR pt racv ro ru sk sl sr@ijekavianlatin sr@ijekavian sr@latin sr sv tl tr uk vi zh_CN zh_TW	$P-tutorial	$US/$P/translations/%/$LC
wesnoth	af ang@latin ang ar bg ca_ES@valencia ca cs da de el en_GB en@shaw eo es et eu fi fr fur_IT ga gl he hr hu id is it ja ko la lt lv mk mr nb_NO nl pl pt_BR pt racv ro ru sk sl sr@ijekavianlatin sr@ijekavian sr@latin sr sv tl tr uk vi zh_CN zh_TW	$P-units	$US/$P/translations/%/$LC
wesnoth	af ang@latin ang ar bg ca_ES@valencia ca cs da de el en_GB en@shaw eo es et eu fi fr fur_IT ga gl he hr hu id is it ja ko la lt lv mk mr nb_NO nl pl pt_BR pt racv ro ru sk sl sr@ijekavianlatin sr@ijekavian sr@latin sr sv tl tr uk vi zh_CN zh_TW	$P-utbs	$US/$P/translations/%/$LC
wget	be bg ca cs da de el en_GB eo es et eu fi fr ga gl he hr hu id it ja lt nb nl pl pt_BR pt ro ru sk sl sr sv tr uk vi zh_CN zh_TW
wol	de es fr it sv
wput	da de el es fi fr it nl pl ru sv tr zh
wxdfast	cs de es fr hu id nl pl pt_BR ru tr	wxDFast
wxHexEditor	tr
wxpython	ca_ES@valencia cs_CZ da_DK de_DE en_US es_ES fr_FR gl_ES hr_HR hu_HU it_IT ja_JP lv_LV nl_NL nn_NO pl_PL pt_BR ru_RU sk_SK sl_SI sr_RS sv_SE tr_TR uk_UA zh_CN zh_TW	Editra	$PY/wx-2.8-gtk2-unicode/wx/tools/Editra/locale/%/$LC
wxWidgets	ca cs da de el es fi fr hu id it ja nl pl ru sl sv tr uk zh_CN zh_TW	wxstd
wxWidgets	it	wxmsw
xarchiver	bg ca cs da de el en_GB es eu fi fr hu id ja nb_NO nl pl pt_BR pt_PT ru sq sv tr uk
xchat	be ca cs de el es fi fr gl hu it ja kn ko lt mk nl pa pl pt ru sq sr sv th uk vi zh_CN zh_TW
xchat-plugin	be ca cs de el es fi fr gl hu it ja kn ko lt mk nl pa pl pt ru sq sr sv th uk vi zh_CN zh_TW	xchat
xchm	be bg cs de es fr hu it lv pl pt_BR pt_PT ro ru sk sv uk zh_CN zh_TW
Xdialog	ca de es fr hu id it nl no_NO pl pt_BR ru sv_SE
xfburn	ar ast bg ca cs da de el en_AU en_GB en es et eu fi fr gl he hr hu id is it ja kk ko lt lv nb nl nn oc pa pl pt_BR pt ru si sk sq sr sv th tr ug uk ur ur_PK vi zh_CN zh_TW
xfce4-appfinder	am ar ast be bg bn ca cs da de el en_AU en_GB eo es et eu fi fr gl he hr hu id is it ja kk ko lt lv ms nb nl nn oc pa pl pt_BR pt ro ru si sk sl sq sr sv te th tr ug uk ur ur_PK vi zh_CN zh_HK zh_TW
xfce4-mixer	am ar ast bg ca cs da de el en_GB es eu fi fr gl he hr hu id is it ja kk ko lt lv nb nl nn pl pt_BR pt ro ru si sk sr sv tr ug uk ur ur_PK vi zh_CN zh_TW
xfce4-notifyd	ar ast ca cs da de el en_GB es eu fi fr gl hu id it ja kk lv nb nl pa pl pt_BR pt pt_PT ro ru si sk sq sv tr ug uk zh_CN zh_TW
xfce4-panel	am ar ast be bg bn ca cs da de el en_AU en_GB eo es et eu fi fr gl he hr hu id is it ja kk ko lt lv ms nb nl nn oc pa pl pt_BR pt ro ru si sk sq sr sv te th tr ug uk ur ur_PK vi zh_CN zh_HK zh_TW
xfce4-ristretto	ar ast bg ca cs da de el en_GB es eu fi fr gl hr hu id is it ja ko lt lv nb nl pl pt_BR pt ro ru sk sl sr sv te tr ug uk ur ur_PK vi zh_CN zh_TW	ristretto
xfce4-session	am ar ast be bg bn ca cs da de el en_AU en_GB eo es et eu fi fr gl he hr hu id is it ja kk ko lt lv ms nb nl nn oc pa pl pt_BR pt ro ru si sk sq sr sv te th tr ug uk ur ur_PK vi zh_CN zh_HK zh_TW
xfce4-settings	ar ast bg bn ca cs da de el en_AU en_GB es eu fi fr gl he hr hu id is it ja kk ko lt lv nb nl nn oc pa pl pt_BR pt ro ru si sk sr sv te th tr ug uk ur ur_PK zh_CN zh_HK zh_TW
xfce4-taskmanager	ar ast be bg ca cs da de el en_AU en_GB es eu fi fr gl he hr hu id is it ja kk ko lt lv nb nl oc pa pl pt_BR pt ru si sk sl sq sr sv te tr ug uk ur ur_PK vi zh_CN zh_HK zh_TW
xfce-utils	af am ar ast az be bg bn_IN bn ca cs da de dz el en_GB eo es es_MX et eu fa fi fr gl gu he hi hr hu hy id it ja ka kk ko ku lt lv mk mr ms nb nl pa pl pt_BR pt ro ru si sk sq sv ta te tr ug uk ur ur_PK vi zh_CN zh_TW
xfconf	ar ast bn ca cs da de el en_GB es eu fi fr gl he hr hu id is it ja kk ko lt lv nb nl nn pa pl pt_BR pt ro ru si sk sv te tr ug uk ur ur_PK zh_CN zh_TW
xfdesktop	am ar ast az be bg bn_IN bn ca cs da de dz el en_GB eo es es_MX et eu fa fi fr gl gu he hi hr hu hy id is it ja ka kk ko lt lv mk mr ms nb nl nn pa pl pt_BR pt ro ru si sk sq sv ta te tr ug uk ur ur_PK vi zh_CN zh_TW
xfe	bs ca cs da de el es_AR es_CO es fr hu it ja nl no pl pt_BR pt_PT ru sv tr zh_CN zh_TW
xfmedia	ca cs de dz es eu fi fr gl gu he hu it ja ka lt pl pt_BR ru sk uk vi zh_CN zh_TW
xfmpc	ar ast ca cs da de el en_GB es eu fi fr gl hr hu id it ja nl pt_BR pt ru si sk sl sv tr ug uk ur ur_PK zh_CN zh_TW
xfprint	am ar az be bg bn_IN ca cs da de dz el en_GB eo es es_MX et eu fa fi fr gl gu he hi hu id it ja ka ko lt lv mk mr ms nl pa pl pt_BR pt ro ru si sk sq sv ta tr uk ur vi zh_CN zh_TW
xfsprogs	de pl
xfwm4	am ar ast be bg bn ca cs da de el en_AU en_GB eo es et eu fi fr gl he hr hu id is it ja kk ko lt lv ms nb nl nn oc pa pl pt_BR pt ro ru si sk sq sr sv te th tr ug uk ur ur_PK vi zh_CN zh_HK zh_TW
xine-lib	cs de en_US eo es eu fr it ja pl pt_BR sk tr	libxine2
xine-ui	cs de eo es eu fr it ja nb pl pt_BR ru sk uk
xine-ui	cs de es eu fr it ja nb pl pt_BR ru sk uk	xitk
xorg-xkeyboard-config	af az bg ca crh cs da de el en_GB eo es fi fr gl hu id it ka ko ky lt nb nl pl ro ru rw sk sl sq sr sv tr uk vi zh_CN zh_TW	xkeyboard-config
xournal	ca cs de es fr it nl pt_BR
xpad	af bg cs da de en_GB es et fi fr ga hr hu it ja ko lv nl pt ro ru rw sv th tr vi zh_CN zh_TW
xsane	ca cs da de es fi fr hu it ja nl pa pl pt_BR pt ro ru sk sl sr sv tr vi zh_CN zh
xscreensaver	ca da de es et fi fr hu it ja ko nb nl pl pt_BR pt ru sk sv vi wa zh_CN zh_TW
xtrkcad	de_DE fi pt_BR
xz	cs de fr it pl
yad-gtk3	de fr it ru sk uk zh_TW	yad
yad	de fr it pt_BR ru sk uk zh_TW
yasr	es fr
ypbind-mt	de sv
yp-tools	de sv
zenity	am ar as ast az be@latin be bg bn_IN bn bs ca ca@valencia cs cy da de dz el en_CA en_GB en@shaw es et eu fa fi fr ga gl gu he hi hr hu id is it ja ka kn ko ku lt lv mai mg mi mk ml mn mr ms nb ne nl nn oc or pa pl ps pt_BR pt ro ru rw si sk sl sq sr@latin sr sv ta te th tr ug uk vi xh zh_CN zh_HK zh_TW
zim	ca cs da de el en_GB es et fr gl he hu it ja ko nl pl ru sk sl sr sv tr uk zh_CN zh_TW
zvbi	de en@boldquot en@quot es fr it nl pl
