alsaplayer	de en_GB fr pl sv
aria2	ar bg ca da de el en@boldquot en@quot es fi fr he hu id it ja ko nl nn pl pt_BR pt ru sk sr sv th tr uk vi zh_CN zh_TW
binutils	bg da es fi fr id ja ro ru rw sk sv tr uk vi zh_CN zh_TW
binutils	bg da de es fi fr ga id ms nl pt_BR ro ru rw sv tr vi	gprof
binutils	bg da es fi fr ga id ja sv tr vi zh_CN zh_TW	ld
binutils	da es fi fr id ja ro ru rw sv tr vi zh_CN	bfd
binutils	da de es fi fr ga id nl pt_BR ro sv tr vi zh_CN	opcodes
binutils	es fr id ru rw tr	gas
bleachbit	ar ast be bg bn bs ca cs da de el en_AU en_GB eo es et eu fi fo fr gl he hi hr hu hy ia id it ja ko ku ky lt ms my nb nds nl pl pt_BR pt ro ru se si sk sl sr sv ta te th tr ug uk uz vi zh_CN zh_TW
blender	ar bg ca cs de el es fi fr hr_HR hr it ja ko nl pl pt_BR ro ru sr@Latn sr sv uk zh_CN		$US/$P/2.57/datafiles/locale/%/$LC
brasero	af ar as ast be bg bn_IN bn br ca ca@valencia cs da de dz el en_GB en@shaw es et eu fi fr ga gl gu he hi hu it ja kn ko ku lt lv mai mk ml mr nb nds nl oc or pa pl pt_BR pt ro ru sl sr@latin sr sv ta te th tr uk vi zh_CN zh_HK zh_TW
cherokee	ca de en es fr gl it jp nl pl pt_BR sv_SE zh_CN
deadbeef	be bg bn ca cs da de el en_GB eo es et fa fi fr gl he hr hu id it ja kk km lg lt nb nl pl pt_BR pt ro ru si sk sl sr@latin sr sv te tr ug uk vi zh_CN zh_TW
fcitx	zh_CN
gdk-pixbuf	af ang ar as ast az be@latin be bg bn_IN bn br bs ca ca@valencia crh cs cy da de dz el en_CA en_GB en@shaw eo es et eu fa fi fr ga gl gu he hi hr hu hy ia id io is it ja ka kn ko ku li lt lv mai mi mk ml mn mr ms my nb nds ne nl nn nso oc or pa pl ps pt_BR pt ro ru si sk sl sq sr@ije sr@latin sr sv ta te th tk tr tt ug uk uz@cyrillic uz vi wa xh yi zh_CN zh_HK zh_TW
gdmap	bg da de es fr he hr it nb no ru sv tr	GdMap
gejengel	es nl
gnome-commander	ar bg ca cs de dz el en_CA en_GB eo es eu fi fr ga hr hu it ja ko nb ne nl oc pa pl pt_BR pt ro ru rw sk sl sq sr@Latn sr sv uk vi zh_CN zh_TW
gnome-keyring	ar as ast az be@latin be bg bn_IN bn bs ca ca@valencia cs cy da de dz el en_CA en_GB en@shaw es et eu fa fi fr ga gl gu he hi hr hu id is it ja ka kn ko lt lv mai mg mk ml mn mr ms nb ne nl nn oc or pa pl pt_BR pt ro ru rw si sk sl sq sr@latin sr sv ta te th tr uk vi xh zh_CN zh_HK zh_TW
gnome-vfs	af am ar as ast az be bg bn_IN bn bs ca ca@valencia cs cy da de dz el en_CA en_GB en@shaw eo es et eu fa fi fr ga gl gu he hi hr hu id is it ja ka kn ko ku li lt lv mai mg mk ml mn mr ms nb ne nl nn nso oc or pa pl pt_BR pt ro ru rw sk sl sq sr@ije sr@latin sr sv ta te th tr uk uz@cyrillic uz vi wa xh yi zh_CN zh_HK zh_TW zu	gnome-vfs-2.0
gnutls	cs de en@boldquot en@quot fr it ms nl pl sv vi zh_CN	lib$P
gparted	ar bg br ca ca@valencia cs da de dz el en_CA en_GB eo es et eu fa fi fr gl gu he hu id is it ja kk ko lt lv mk nb ne nl oc pa pl pt_BR pt ro ru rw si sk sl sr@latin sr sv te th tr uk vi zh_CN zh_HK zh_TW
graveman	cs de es fr hu it ja lt nl no pl pt_BR ru sv
gst-plugins-good	af az bg ca cs da de el en_GB es eu fi fr gl hu id it ja lt lv mt nb nl or pl pt_BR ro ru sk sl sq sr sv tr uk vi zh_CN zh_HK zh_TW	$P-0.10
gtk+	af am ang ar as ast az_IR az be@latin be bg bn_IN bn br bs ca ca@valencia crh cs cy da de dz el en_CA en_GB eo es et eu fa fi fr ga gl gu he hi hr hu hy ia id io is it ja ka kk kn ko ku li lt lv mai mi mk ml mn mr ms my nb nds ne nl nn nso oc or pa pl ps pt_BR pt ro ru rw si sk sl sq sr@ije sr@latin sr sv ta te th tk tr tt ug uk ur uz@cyrillic uz vi wa xh yi zh_CN zh_HK zh_TW	gtk20
gtk+	af am ang ar as ast az_IR az be@latin be bg bn_IN bn br bs ca ca@valencia crh cs cy da de dz el en_CA en_GB eo es et eu fa fi fr ga gl gu he hi hr hu hy ia id io is it ja ka kk kn ko ku li lt lv mai mi mk ml mn mr ms my nb nds ne nl nn nso oc or pa pl ps pt_BR pt ro ru rw si sk sl sq sr@ije sr@latin sr sv ta te th tk tr tt ug uk ur uz@cyrillic uz vi wa xh yi zh_CN zh_HK zh_TW	gtk20-properties
gucharmap	af am ar as ast az be@latin be bg bn_IN bn br bs ca ca@valencia cs cy da de dz el en_CA en_GB en@shaw eo es et eu fa fi fr ga gl gu he hi hr hu id is it ja ka kn ko lt lv mai mi mk ml mn mr ms nb ne nl nn oc or pa pl pt_BR pt ro ru rw si sk sl sq sr@latin sr sv ta te th tr ug uk vi wa xh zh_CN zh_HK zh_TW
gvfs	af ar as ast be@latin bg bn_IN bn ca ca@valencia cs da de el en_GB en@shaw es et eu fi fr ga gl gu he hi hu id it ja kk kn ko ku lt lv mai mk ml mr nb nds nl nn or pa pl pt_BR pt ro ru sk sl sq sr@latin sr sv ta te th tr ug uk vi zh_CN zh_HK zh_TW
lynx	ca cs da de en et fi fr hu id it ja nl pt_BR ru sl sv tr uk vi zh_CN zh_TW
lyx	ar ca cs de el en es eu fi fr gl he hu id it ja nb nn pl pt ro ru sk sr sv tr uk zh_CN zh_TW
manaplus	cs de es fi fr id it ja nl_BE pl pt_BR pt ru tr zh_CN
mc	az be bg ca cs da de_CH de el eo es eu fi_FI fi fr gl hu ia id it_IT it ja ka ko lt lv mn nb nl pl pt_BR pt ro ru sk sl sr sv sv_SE ta tr uk vi wa zh_CN zh_TW
midori	ar ast be ca cs da de el en_GB eo es et eu fi fr gl he hr hu id it ja ko lt nl no pa pl pt_BR pt ro ru sk sr@latin sr sv tr ug uk zh_CN zh_TW
mutt	bg ca cs da de el eo es et eu fr ga gl hu id it ja ko lt nl pl pt_BR ru sk sv tr uk zh_CN zh_TW
mypaint	cs de en_CA es fr hu id it ja ko nb nn_NO pl pt_BR ru sl sv uk zh_CN zh_TW
ogmrip	cs de fr nb ru sk
openerp-web	de_DE es_ES fr_FR it_IT	$PY/locales/%/$LC	messages
radiotray	de en_GB es fr gu hu it lt pl pt_BR pt ro ru sk sl sv te tr uk zh_CN
rawstudio	ca cs da de en es fi fr it nb nl pl pt_BR ru sv
sakura	ca cs de es fr hr hu it ja pt_BR ru zh_CN
samba	ar cs da de es fi fr hu it ja ko nb nl pl pt_BR ru sv zh_CN zh_TW	pam_winbind
samba	de	net
sane-backends	bg cs da de en_GB eo es fi fr gl it ja nb nl pl pt ru sv uk
slitaz-tools-boxes	es_AR fr pt_BR	slitaz-boxes tazbox
slitaz-tools	es_AR fr pt_BR	$P tazinst
tazpanel	es fr pt_BR ru
tazusb	fr pt_BR	$P $P-box
transmission	an ar ast az be@latin be bg bn bo br bs ca ca@valencia ceb ckb cs da de el en_AU en_CA en_GB eo es et eu fa fi fil fo fr ga gl gv he hi hr hu hy ia id is it ja ka kk ko ku li lt lv mk ml mr ms mt nb nl nn oc pa pl pt_BR pt ro ru sk sl sq sr sv ta_LK te th tl tr ug uk ur uz vi zh_CN zh_TW	$P-gtk
ufraw	ca cs da de es fr it ja ko nb nl pl pt ru sr@latin sr sv zh_CN
util-linux-ng	ca cs da de es et eu fi fr gl hu id it ja nl pl pt_BR ru sl sv tr uk vi zh_CN zh_TW	util-linux
vorbis-tools	be cs da en_GB eo es fr hr hu nl pl ro ru sk sv uk vi
vte	am ang ar as ast az be@latin be bg bn_IN bn bs ca ca@valencia cs cy da de dz el en_CA en_GB en@shaw eo es et eu fa fi fr ga gl gu he hi hr hu id is it ja ka kn ko ku ky li lt lv mai mi mk ml mn mr ms nb nds ne nl nn oc or pa pl pt_BR pt ro ru rw si sk sl sq sr@latin sr sv ta te th tr ug uk vi wa xh zh_CN zh_HK zh_TW	vte-0.0
wxpython	ca cs da de el es fi fr hu id it ja nl pl ru sl sv tr uk zh_CN zh_TW	wxstd
wxpython	it	wxmsw
xfe	bs ca cs da de el es_AR es fr hu it ja no pl pt_BR pt_PT ru sv tr zh_CN zh_TW
xpad	af bg cs da de en_GB es et fi fr ga hr hu it ja ko lv nl pt ro ru rw sv th tr vi zh_CN zh_TW
